config.text was created: 8/9/2021 12:20:45 AM
Filesize is: 202384 bytes

CheckAssignMap
Group 0
CorrectionAssignMapTitle - 操作設定の修復
CorrectionAssignMapMessage - 操作設定のうち「決定」や「キャンセル」など<br>重要な操作の割り当て内容に問題があったため<br>自動修復を行いました。

Group 1
CorrectionAssignMapTitle - Control Settings Restored
CorrectionAssignMapMessage - An issue has been encountered with the assignment<br>of important commands such as "Confirm" or "Cancel" <br>in your control settings. Initial control settings have <br>been automatically restored.


Config
Group 0
Title - オプション
Category_Game - ゲーム設定
Category_Game_Hint - ゲームプレイに関連する機能や<br>カメラ操作などの設定をします。
Category_Device - 操作設定
Category_Device_Hint - キーボード・マウス・<%GamePad>など<br>入力機器に関連する設定をします。
Category_Sound - 音声設定
Category_Sound_Hint - 音声に関連する設定をします。
Category_Graphics - 描画設定
Category_Graphics_Hint - グラフィックの描画に関連する設定をします。
SubCategory_GameFunction - 機能設定
SubCategory_GameFunction_Hint - ゲーム内の各種機能について設定をします。
SubCategory_Camera - カメラ設定
SubCategory_Camera_VITA - ゲーム内カメラ設定
SubCategory_Camera_Hint - カメラの挙動に関連する設定をします。
SubCategory_TextEffect - テキスト演出設定
SubCategory_TextEffect_Hint - ダメージやアイテム取得表示など<br>テキスト演出に関連する設定をします。
SubCategory_Notice - 通知設定
SubCategory_Notice_Hint - ゲーム内の各種通知について設定をします。
SubCategory_Talk - 会話設定
SubCategory_Talk_Hint - 会話システムに関連する設定をします。
SubCategory_Capture - 撮影設定
SubCategory_Capture_Hint - スクリーンショットに関連する設定をします。
SubCategory_Other - その他設定
SubCategory_Other_Hint - エステ、ライドロイド、ダークブラスト<br>などのシステムに関連する設定をします。
SubCategory_InputGuide - 操作ガイド表示タイプ
SubCategory_InputGuide_Hint - ゲーム内で表示される操作ガイドの<br>表示タイプを設定します。
SubCategory_PadDefine - コントローラー初期設定
SubCategory_PadDefine_Hint - コントローラーの初期設定をします。
SubCategory_KeyBind_Pad - 機能割当（<%GamePad>）
SubCategory_KeyBind_Pad_Hint - <%GamePad>の入力を<br>どの機能に割り当てるか設定します。
SubCategory_KeyBind_Mouse - 機能割当（マウス）
SubCategory_KeyBind_Mouse_Hint - マウスの入力を<br>どの機能に割り当てるか設定します。
SubCategory_KeyBind_Keyboard - 機能割当（キーボード）
SubCategory_KeyBind_Keyboard_Hint - キーボードの入力を<br>どの機能に割り当てるか設定します。
SubCategory_MainInputDevice - おもに使用する操作機器
SubCategory_MainInputDevice_Hint - おもに使用する操作機器を選択します。
SubCategory_ActionType - アクションタイプ選択
SubCategory_ActionType_Hint - アクションタイプを選択します。
SubCategory_SoundVolume - 音量
SubCategory_SoundVolume_Hint - BGMやSEなどの音量の設定をします。
SubCategory_SoundFunction - 再生機能
SubCategory_SoundFunction_Hint - 音声再生に関連する機能の設定をします。
SubCategory_GraphicsFunction - 描画機能
SubCategory_GraphicsFunction_Hint - 描画に関連する機能の設定をします。
SubCategory_GraphicsQuality - 表示品質
SubCategory_GraphicsQuality_Hint - 表示品質の設定をします。
SubCategory_FilterView - 画面フィルター<pict Arcscash>
SubCategory_FilterView_Hint - 画面フィルターの設定をします。
SubCategory_ResetWindow - ウィンドウ初期化
SubCategory_ResetWindow_Hint - 全ウィンドウの表示位置と表示サイズを<br>初期化します。
SubCategory_GraphicsPreset - 簡易グラフィック設定
SubCategory_GraphicsPreset_Hint - グラフィック設定を一括設定します。<br>数値を高く設定すると描画クオリティが高くなりますが<br>処理負荷が大きくなります。
GraphicsPreset_Info - グラフィック設定を一括設定します。<br>数値を高く設定すると描画クオリティが高くなりますが<br>処理負荷が大きくなります。<br><br>ご利用の環境の推奨設定は <yellow>$(0)<c> です。
GraphicsPreset_Info_CS - グラフィック設定を一括設定します。<br>数値を高く設定すると描画クオリティが高くなりますが<br>処理負荷が大きくなります。
GraphicsPreset_Button_Change - 変更
GraphicsPreset_Button_Cancel - キャンセル
GraphicsPreset_choice_1 - 1：最低
GraphicsPreset_choice_2 - 2：低
GraphicsPreset_choice_3 - 3：中
GraphicsPreset_choice_4 - 4：高
GraphicsPreset_choice_5 - 5：スーパー
GraphicsPreset_choice_6 - 6：ウルトラ
GraphicsPreset_choice_1_CS - 1：フレームレート重視
GraphicsPreset_choice_2_CS - 2：バランス重視
GraphicsPreset_choice_3_CS - 3：画質重視
LogoutGuide_Title - 設定の適用について
LogoutGuide_Message - 変更した描画設定の一部は<br>次回ログインから適用されます。<br><br>今すぐログアウトしますか？
LogoutGuide_Message_CantLogout - 変更した描画設定の一部は<br>次回ログインから適用されます。
MenuTreeBasic - 基本設定
MenuTreeDirection - 演出設定
MenuTreeDraw - 描画設定
MenuTreeSound - 音声設定
MenuTreeControl - 操作設定
MenuTreeCommunication - コミュニケーション
MenuTreeSystem - システム
MenuButtonBasic - 基本設定
MenuButtonNotice - 通知設定
MenuButtonCamera - カメラ設定
MenuButtonCamera_v - ゲーム内カメラ設定
MenuButtonShoot - 撮影設定
MenuButtonChat - チャット設定
MenuButtonDirection - 演出設定
MenuButtonDrawFunction - 描画機能
MenuButtonDrawFilter - 画面フィルター<pict Arcscash>
MenuButtonDrawShadow - 影設定
MenuButtonDrawDisplay - 表示設定
MenuButtonSound - 音声設定
MenuButtonOperationType - おもに使用する操作機器
MenuButtonActionType - アクションタイプ選択
MenuButtonSndVolume - 音量
MenuButtonSndPlay - 再生設定
MenuButtonCtrl - 操作設定
MenuButtonWindow - ウィンドウ初期化
MenuButtonSystem - システム
MenuButtonReset - 設定の初期化
MenuButtonExit - 破棄して戻る
MenuButtonExitWithSave - 変更を反映して戻る
ThreeChoiceMenuTitle - 終了確認
ThreeChoiceMenuMessageApply - オプション画面を閉じて戻ります。<br>変更を反映しますか？<br>
ThreeChoiceMenuButtonExit - 破棄して戻る
ThreeChoiceMenuButtonExitWithSave - 変更を反映して戻る
ThreeChoiceMenuButtonCancel - キャンセル
ConfirmTitleInit - 初期化確認
ConfirmMessageInit - すべての操作設定を初期化します。<br>よろしいですか？
ConfirmTitle - 終了確認
ConfirmMessageApply - 変更を反映します。<br>よろしいですか？
ConfirmMessageDisapply - 変更を破棄します。<br>よろしいですか？
ConfirmButtonApply - 変更を保存して終了する
ConfirmButtonDisapply - 変更を破棄して終了する
ConfirmButtonCancel - オプションに戻る
BasicTextSmutFilter - テキストフィルタリング設定
VitaCtrlTextSwapLR - L/Rボタン機能入れ替え（カスタム時無効）
VitaCtrlTextSwapStartSelect - START/SELECTボタン機能入れ替え(カスタム時無効)
VitaCtrlTextNormalCtrlType - 通常視点操作タイプ
VitaCtrlTextShoulderCtrlType - 肩越し視点操作タイプ
VitaCtrlTextSavePartySetting - パーティー設定の保存
VitaCtrlTextLockonChange - <%RStick>によるロックオン切り替え
VitaCtrlTextNavi - ナビアイコン表示切り替え
MltPtMatchingButton - 複数ブロックマッチングの対象クエストを受注する時<br>カーソル位置をどちらのボタンにするかを設定します。<br>　※一部クエストを除きます
ConfirmTitleWindowInit - ウィンドウ初期化確認
ConfirmMessageWindowInit - すべてのウィンドウの<br>表示位置と表示サイズを初期化します。<br>よろしいですか？
ConfirmMessageWindowInitEnd - ウィンドウの表示位置と表示サイズを初期化しました。
WindowTitleInitText - ウィンドウ初期化設定
WindowInitHint - 全ウィンドウの表示位置と表示サイズを<br>初期化します。
WindowRadioButtonInitText - 全ウィンドウの位置とサイズを初期化する
EstheTitleText - ヘアスタイル・ヘッドパーツ・アクセサリー選択方式
EstheHint - キャラクタークリエイトおよびエステで選択する<br>ヘアスタイル・ヘッドパーツ・アクセサリーウィンドウの<br>タイプを設定します。
EstheRadioButtonText1 - 小ウィンドウ　複数表示可能
EstheRadioButtonText2 - 大ウィンドウ　タブ化　複数表示不可
CtrlKeyboardTitle - キーボード操作設定
CtrlTabTitleNView - 通常視点
CtrlTabTitleZView - 肩越し視点
CtrlTabTitleWindow - ウィンドウ
CtrlTabTitleOther - その他
CtrlTabTitleShortcut - ショートカット
CtrlTabTitleAction - アクション
CtrlTabTitleLobbyAction - ロビアク
CtrlTabTitleBasicSet - 基本設定
CtrlMainCtgNameNView - 通常視点操作
CtrlMainCtgNameZView - 肩越し視点操作
CtrlMainCtgNameWindow - ウィンドウ操作
CtrlMainCtgNameOther - その他操作
CtrlMainCtgNameShortcut - ショートカット操作
CtrlMainCtgNameAction - アクション操作
CtrlMainCtgNameLobbyAction - ロビーアクション操作
CtrlSubCtgNameViewMove - キャラクター移動
CtrlSubCtgNameViewCamera - カメラ距離切り替え
CtrlSubCtgNameViewAction - アクション
CtrlSubCtgNameViewActionSupport - アクションサポート
CtrlSubCtgNameViewMenu - メニュー
CtrlSubCtgNameViewPalette - 武器パレット送り
CtrlSubCtgNameViewChat - チャット
CtrlSubCtgNameViewSubPalette - サブパレット実行
CtrlSubCtgNameViewMap - マップ表示
CtrlSubCtgNameWindowBasic - 決定／キャンセル
CtrlSubCtgNameWindowChat - チャット
CtrlSubCtgNameWindowPage - ページ送り
CtrlSubCtgNameWindowTab - タブ送り
CtrlSubCtgNameWindowDetailTab - 詳細ウィンドウタブ送り
CtrlSubCtgNameWindowCtrlWindow - 操作ウィンドウ変更
CtrlSubCtgNameOtherShortcut - ショートカット
CtrlSubCtgNameOtherShortcutWord - ショートカットワード
CtrlSubCtgNameOtherMainPalette - 武器パレット直接変更
CtrlSubCtgNameOtherSubPalette - サブパレット実行
CtrlSubCtgNameCtrlCtrl - ショートカット設定
CtrlSubCtgNameCtrlWindow - ウィンドウショートカット設定
CtrlSubCtgNameBasic - 基本操作
CtrlSubCtgNameAssist - 補助操作
CtrlSubCtgNameLobbyAction - ロビーアクションのキー設定
CtrlSubCtgNameActionMenu - アクション／メニュー操作
CtrlPresetNameRNViewRcm - 右利き通常視点オススメ
CtrlPresetNameRZViewRcm - 右利き肩越し視点オススメ
CtrlPresetNameRNViewKbd - 右利き通常視点キーボードのみ
CtrlPresetNameRZViewKbd - 右利き肩越し視点キーボードのみ
CtrlPresetNameLNViewRcm - 左利き通常視点オススメ
CtrlPresetNameLZViewRcm - 左利き肩越し視点オススメ
CtrlPresetNameLNViewKbd - 左利き通常視点キーボードのみ
CtrlPresetNameLZViewKbd - 左利き肩越し視点キーボードのみ
CtrlPresetNameRcm1 - オススメ1
CtrlPresetNameRcm2 - オススメ2
CtrlPresetNameNViewRcm1 - 通常視点オススメ1
CtrlPresetNameNViewRcm2 - 通常視点オススメ2
CtrlPresetNameZViewRcm1 - 肩越し視点オススメ1
CtrlPresetNameZViewRcm2 - 肩越し視点オススメ2
CtrlPresetNameRRcm - 右利きオススメ
CtrlPresetNameLRcm - 左利きオススメ
CtrlPresetNameCutom - カスタム
CtrlPresetNameRcm - オススメ
CtrlAssignNameMouseL - 左クリック
CtrlAssignNameMouseR - 右クリック
CtrlAssignNameMouseM - ホイールクリック
CtrlAssignNameMouseWheel - ホイール
CtrlAssignNameMouseX1 - サイドボタン（X1）
CtrlAssignNameMouseX2 - サイドボタン（X2）
CtrlFuncNameNone - なし
CtrlFuncNameMoveForward - 移動：前
CtrlFuncNameMoveRight - 移動：右
CtrlFuncNameMoveLeft - 移動：左
CtrlFuncNameMoveBack - 移動：後
CtrlFuncNameNormalAttack - 通常攻撃
CtrlFuncNamePhotonArts - PA／テクニック
CtrlFuncNameAvoid - 回避アクション
CtrlFuncNameJump - ジャンプ
CtrlFuncNameAccess - アクセス
CtrlFuncNameWeponAction - 武器アクション
CtrlFuncNameLockon - ロックオン
CtrlFuncNameLockonNext - ターゲット切り替え
CtrlFuncNameChangeView - 視点切り替え
CtrlFuncNameCameraDistance - カメラ距離変更
CtrlFuncNameCameraSelect - カメラ選択
CtrlFuncNameCameraLightSetting - カスタムライト設定
CtrlFuncNameCameraMoveUD - カメラ上下移動
CtrlFuncNameAutoRun - オートラン
CtrlFuncNameRefuseFollowRun - 追尾オートラン拒否
CtrlFuncNameOpenMainMenu - メインメニュー
CtrlFuncNameOpenSelectMenu - クイックメニュー
CtrlFuncNameOpenEquip - 装備
CtrlFuncNameOpenPlayerList - 周囲のキャラクター
CtrlFuncNameMainPaletteForward - 武器パレット順送り
CtrlFuncNameMainPaletteBack - 武器パレット逆送り
CtrlFuncNameMainPaletteA - アクション1
CtrlFuncNameMainPaletteB - アクション2
CtrlFuncNameMainPaletteC - アクション3
CtrlFuncNameBackPallete - 裏パレット切り替え
CtrlFuncNameMainPaletteUp - 武器パレット下へ
CtrlFuncNameMainPaletteDown - 武器パレット上へ
CtrlFuncNameStartChat - チャットの開始
CtrlFuncNameStartChatPublic - 周囲チャット起動
CtrlFuncNameStartChatParty - パーティーチャット起動
CtrlFuncNameStartChatGuild - チームチャット起動
CtrlFuncNameStartChatWhisper - ウィスパーチャット起動
CtrlFuncNameSubpaletteChange - サブパレットカーソル移動
CtrlFuncNameSubpalette - サブパレット実行
CtrlFuncNameSubpaletteForward - サブパレット順送り
CtrlFuncNameSubpaletteLeft - サブパレットカーソル左
CtrlFuncNameSubpaletteRight - サブパレットカーソル右
CtrlFuncNameCameraNear - キャラクターに近づける
CtrlFuncNameCameraFar - キャラクターから遠ざける
CtrlFuncNameCameraUp - 上に移動
CtrlFuncNameCameraDown - 下に移動
CtrlFuncNameCameraNext - カメラ選択順送り
CtrlFuncNameCameraPrev - カメラ選択逆送り
CtrlFuncNameUseCameraLight1 - ライト1を使用する
CtrlFuncNameUseCameraLight2 - ライト2を使用する
CtrlFuncNameUseCameraLight3 - ライト3を使用する
CtrlFuncNameUseDeafultCameraLight - 通常ライトを使用する
CtrlFuncNameScreenShoot - スクリーンショット撮影
CtrlFuncNameMovie - 動画撮影
CtrlFuncNameDecide - 決定
CtrlFuncNameCancel - キャンセル
CtrlFuncNameChangeMouseMode - マウスモード切り替え
CtrlFuncNameAllWindowClose - メインメニューを閉じる
CtrlFuncNameMultiSelect - 複数選択
CtrlFuncNameFunction - 機能拡張
CtrlFuncNameMove - 操作項目の移動
CtrlFuncNamePageForward - ページ順送り
CtrlFuncNamePageBack - ページ逆送り
CtrlFuncNameTabForward - タブ順送り
CtrlFuncNameTabBack - タブ逆送り
CtrlFuncNameWindowTabForward - 詳細ウィンドウタブ順送り
CtrlFuncNameWindowTabBack - 詳細ウィンドウタブ逆送り
CtrlFuncNameChangeWindow - 操作ウィンドウ変更
CtrlFuncNameCtrlTabForward - 操作ウィンドウ変更順送り
CtrlFuncNameCtrlTabBack - 操作ウィンドウ変更逆送り
CtrlFuncNameCtrlException - 特殊操作
CtrlFuncNameCtrlException02 - 特殊操作2
CtrlFuncNameStctWord - ショートカットワード実行
CtrlFuncNameChangeToMainPalette - パレット切り替え
CtrlFuncNameChangeRadarMap - レーダーマップ切り替え
CtrlFuncNameChangeAreaMap - リージョン・シティマップ表示/非表示
CtrlFuncNameOpenItemPack - アイテム
CtrlFuncNameOpenCustomize - カスタム
CtrlFuncNameOpenMag - マグ
CtrlFuncNameOpenPet - ペット
CtrlFuncNameOpenEventItem - イベントアイテム
CtrlFuncNameOpenEquipWeapon - 武器装備
CtrlFuncNameOpenEquipArmor - 防具装備
CtrlFuncNameOpenSubpalette - サブパレット編集
CtrlFuncNameOpenFriend - フレンドリスト
CtrlFuncNameOpenGuild - チームコマンド
CtrlFuncNameOpenParty - パーティーコマンド
CtrlFuncNameOpenMail - メール
CtrlFuncNameOpenNearCharacter - 周囲のキャラクター
CtrlFuncNameOpenCharaInfo - キャラクター情報
CtrlFuncNameOpenLicense - 称号リスト
CtrlFuncNameOpenMyMenu - クイックメニュー
CtrlFuncNameOpenCommunicationLog - コミュニケーション履歴
CtrlFuncNameOpenProfile - アークスカード情報
CtrlFuncNameOpenLibrary - 図鑑
CtrlFuncNameOpenMutterBoard - ストーリーボード【EP4】
CtrlFuncNameOpenClientOrder - クライアントオーダー
CtrlFuncNameOpenQuestInfo - クエスト情報
CtrlFuncNameOpenSymbolArt - シンボルアート
CtrlFuncNameOpenMacro - チャット設定
CtrlFuncNameOpenConfig - オプション
CtrlFuncNameOpenPayShop - ショップメニュー
CtrlFuncNameOpenACGacha - スクラッチを引く
CtrlFuncNameOpenPayLog - 購入履歴
CtrlFuncNameOpenRentalLimit - レンタル有効期限
CtrlFuncNameOpenLogOut - ログアウト
CtrlFuncNameOpenBingo - アークスビンゴ
CtrlFuncNameOpenInformation - インフォメーション
CtrlFuncNameOpenArksRoad - アークスロード
CtrlFuncNameOpenCraftAchievement - クラフト実績
CtrlFuncNameOpenShipBattle - アークスシップ対抗戦
CtrlFuncNameOpenRecycle - リサイクルショップ
CtrlFuncNameOpenFashion - ファッション編集
CtrlFuncNameOpenGatStatus - ギャザリングステータス
CtrlFuncNameOpenGatAchieve - 達成可能ギャザリング実績
CtrlFuncNameOpenEquipNote - コレクトファイル
CtrlFuncNameOpenBuySG - スタージェムを購入する
CtrlFuncNameOpenPokaRecord - 戦績情報
CtrlFuncNameOpenPokaRankMatch - バトルランク情報
CtrlFuncNameOpenPokaRankMatch_Switch - バトルランク情報(クラウド版)
CtrlFuncNameOpenFashionCat - コーデカタログ
CtrlFuncNameOpenArksLeague - アークスリーグ
CtrlFuncNameOpenBasnetContentInfo - バスタークエスト情報
CtrlFuncNameOpenPolluteEdit - ダークブラスト
CtrlFuncNameOpenSgShop - SGショップ
CtrlFuncNameOpenArksContract - アークスミッション
CtrlFuncNameOpenWebLink - Web連動イベント
CtrlFuncNameOpenWorldmap - ワールドマップ
CtrlFuncNameMuteVoiceChat - マイクのミュート切り替え
CtrlFuncNameWinShortcut - ウィンドウショートカット
CtrlFuncNameWinShortcutT1 - 1
CtrlFuncNameWinShortcutT2 - 2
CtrlFuncNameWinShortcutT3 - 3
CtrlFuncNameWinShortcutT4 - 4
CtrlFuncNameWinShortcutT5 - 5
CtrlFuncNameWinShortcutT6 - 6
CtrlFuncNameWinShortcutT7 - 7
CtrlFuncNameWinShortcutT8 - 8
CtrlFuncNameWinShortcutT9 - 9
CtrlFuncNameWinShortcutT10 - 0
CtrlFuncNameWinShortcutF1 - F1
CtrlFuncNameWinShortcutF2 - F2
CtrlFuncNameWinShortcutF3 - F3
CtrlFuncNameWinShortcutF4 - F4
CtrlFuncNameWinShortcutF5 - F5
CtrlFuncNameWinShortcutF6 - F6
CtrlFuncNameWinShortcutF7 - F7
CtrlFuncNameWinShortcutF8 - F8
CtrlFuncNameWinShortcutF9 - F9
CtrlFuncNameWinShortcutF10 - F10
CtrlFuncNameWinShortcutN1 - Num1
CtrlFuncNameWinShortcutN2 - Num2
CtrlFuncNameWinShortcutN3 - Num3
CtrlFuncNameWinShortcutN4 - Num4
CtrlFuncNameWinShortcutN5 - Num5
CtrlFuncNameWinShortcutN6 - Num6
CtrlFuncNameWinShortcutN7 - Num7
CtrlFuncNameWinShortcutN8 - Num8
CtrlFuncNameWinShortcutN9 - Num9
CtrlFuncNameWinShortcutN10 - Num0
CtrlLobbyActionAssignName - Alt<pict 4space>+<pict 4space>$(0)
CtrlAssignButtonInput - 変更
CtrlAssignButtonWaiting - 待ち
CtrlAssignHint - キーまたはボタンを押してください。<br>（[Esc]キーでキャンセル）
CtrlCtrlAssignTypeT - 1～0
CtrlCtrlAssignTypeF - F1～F10
CtrlCtrlAssignTypeN - Num1～Num0
CtrlCtrlAssignTypeCtrlT - Ctrl+1～0
CtrlCtrlAssignTypeCtrlF - Ctrl+F1～F10
CtrlCtrlAssignTypeCtrlN - Ctrl+Num1～Num0
CtrlCtrlSwapMessage - 「$(0)」と入れ替えました。
CtrlCtrlCaptionFuncName - 項目名
CtrlCtrlCaptionAssign - 現在の設定
CtrlPartition -  / 
CtrlVitaAccessEscape - <pict Sign_L3> ＋ <pict Sign_CIRCLE>
CtrlVitaPalletinfo - 武器パレット切り替えの操作が一部制限されます
CtrlVitaSubPalletinfo - サブパレット切り替えの操作が一部制限されます
CtrlAnnounceTitle - 操作ガイド表示タイプの選択
CtrlAnnounceMessage - 操作説明に表示されるキーまたはボタンの<br>表現方法を、お好みで選択してください。
CtrlAnnounceSelSymbol - 記号タイプ
CtrlAnnounceSelAlphabet - アルファベットタイプ
CtrlAnnounceSelNumber - 数字タイプ
CtrlAnnounceSelKeyboard - キーボードタイプ
CtrlAnnounceExample - 表示例：
CtrlAnnounceExampleKey - <pict Key_ENTER> [Esc] [↑] <pict Key_SPACE>
CtrlAnnounceExampleAlpha - <pict Alpha_A><pict 4space><pict Alpha_B><pict 4space><pict Alpha_RB><pict 4space><pict Alpha_UP>
CtrlAnnounceExampleSign - <pict Sign_CIRCLE><pict 4space><pict Sign_CROSS><pict 4space><pict Sign_R1><pict 4space><pict Sign_UP>
CtrlAnnounceExampleNumber - <pict Number_1><pict 4space><pict Number_2><pict 4space><pict Number_5><pict 4space><pict Number_UP>
CtrlAnnounceHint - 未定
CtrlPadBehaviorTitle - コントローラー初期設定
CtrlPadBehaviorSetting - 手動で設定を行う
CtrlPadBehaviorInitialize - 自動で設定を行う
CtrlPadBehaviorStickTitle - アナログスティック動作設定
CtrlPadBehaviorStickPrepare - アナログスティックの動作設定を開始します。<br>スティックに触らず「閉じる」を押してください。
CtrlPadBehaviorStickSubTitleLU - 1.<%LStick>の「上」範囲の認識テスト
CtrlPadBehaviorStickMessageLU - 「<%LStick>」の認識テストを行います。<br><%LStick>を<c ff007f>「上」<c>に倒しながら、$(0)<pict 4space>を押してください。<br><br><yellow>※反応しない場合は、お手元をご確認いただき、<br><c ff007f>「ANALOG」<c><yellow>や<c ff007f>「MODE」<c><yellow>などと表記されたボタンを<br>押して、アナログモードに切り替えてください。<c>
CtrlPadBehaviorStickSubTitleLL - 2.<%LStick>の「左」範囲の認識テスト
CtrlPadBehaviorStickMessageLL - 次に<br><%LStick>を<green>「左」<c>に倒しながら、$(0)<pict 4space>を押してください。
CtrlPadBehaviorStickSubTitleRU - 3.<%RStick>の「上」範囲の認識テスト
CtrlPadBehaviorStickMessageRU - <%LStick>の認識が終了しました。<br><br>次に、「<%RStick>」の認識テストを行います。<br><%RStick>を<c ff007f>「上」<c>に倒しながら、$(0)<pict 4space>を押して下さい。
CtrlPadBehaviorStickSubTitleRL - 4.<%RStick>の「左」範囲の認識テスト
CtrlPadBehaviorStickMessageRL - 次に<br><%RStick>を<green>「左」<c>に倒しながら、$(0)<pict 4space>を押して下さい。
CtrlPadBehaviorTriggerTitle - トリガー動作設定
CtrlPadBehaviorTriggerMessageL - 「背面左ボタン」がアナログ（トリガー）かどうかを判定します。<br>下の図で光っているボタンを押してください。<br><br><yellow>押しても何も起こらない場合は、アナログ式ではありませんので、<br><c>$(0)<pict 4space><yellow>を押して、次の画面でボタン設定を行なってください。<c>
CtrlPadBehaviorTriggerMessageR - 次に「背面右ボタン」がアナログ（トリガー）かどうかを判定します。<br>下の図で光っているボタンを押してください。<br><br><yellow>押しても何も起こらない場合は、アナログ式ではありませんので、<br><c>$(0)<pict 4space><yellow>を押して、次の画面でボタン設定を行なってください。<c>
CtrlPadBehaviorConfirmInitTitle - 設定の初期化
CtrlPadBehaviorConfirmApplyTitle - 設定の反映
CtrlPadBehaviorConfirmInitMessage - 設定を初期化します。
CtrlPadBehaviorConfirmApplyMessage - 設定を反映します。
CtrlPadBehaviorHelpSetting - コントローラーのスティック、トリガーの認識、<br>各ボタンの割り当て設定を順に行います。
CtrlPadBehaviorHelpInitialize - コントローラーごとに用意された推奨設定に<br>自動で変更します。
CtrlPadBehaviorHelpInitializeDisable - このコントローラーは自動設定に対応していません。
CtrlPadBehaviorHelpTrigger - トリガーの動作設定を行います。
CtrlPadBehaviorButtonDefTitle - ボタン表示設定
CtrlPadBehaviorButtonDefMessage2 - 最後に、ゲーム内で表示するボタンのマークが<br>ご利用中のコントローラーの、どのボタンなのかを設定します。<br><br>リストの上から順に「変更」を押して、<br><c ff007f>「ボタン表示」<c>に合うコントローラーのボタンを押してください。
CtrlPadBehaviorButtonDefCaptionDef - <c ff007f>ボタン表示<c>
CtrlPadBehaviorButtonDefCaptionAssign - 実際のボタン割り当て
CtrlPadBehaviorButtonDefApply - 反映して戻る
CtrlPadBehaviorButtonDefDisapply - 破棄して戻る
CtrlPadBehaviorButtonDefMessage - $(0)として使用するボタンを入力してください。
CtrlPadBehaviorButtonDefDisable - <gray>設定不要(アナログ)<c>
CtrlPadCtrlTitle - コントローラー操作設定
CtrlPadInitToast - コントローラーの自動設定を行いました。コントローラー初期設定で手動設定も可能です。
RadioButtonEnable - 使用する
RadioButtonDisable - 使用しない
RadioButtonShow - 表示する
RadioButtonHide - 表示しない
RadioButtonAllow - 送る
RadioButtonDisallow - 送らない
RadioButtonCtrlNormal - ノーマル
RadioButtonCtrlCustom - カスタム（<pict Sign_TRIANGLE>カスタム設定変更）
RadioButtonCtrlType1 - タイプ1
RadioButtonCtrlType2 - タイプ2
RadioButtonCtrlType3 - タイプ3
RadioButtonSave - 保存する
RadioButtonNotSave - 保存しない
RadioButtonButtonResetOn - 表示する
RadioButtonButtonResetOff - 表示しない
Number0 - 0
Number50 - 50
Number100 - 100
VITA_CustomWindow - <pict Sign_TRIANGLE>カスタム設定変更
VITA_CustomTitle - カスタム設定
VITA_PushButton - ボタン入力
VITA_CustomToast1 - カスタム設定が変更されました。各操作タイプを「カスタム」にすることで有効になります。
VITA_CustomToast2 - 重要な操作が未設定になっています。
VITA_AutoRun - オートラン/サブパレット切替左
VITA_ChangeView - 視点切替/サブパレット切替右
VITA_CustomInfo - カスタム設定はボタン以外にも<br>背面タッチパッドの左上<pict Sign_BACK_L>と右上<pict Sign_BACK_R>を設定できます。<br><br>変更したい項目名を選んでから、ボタンまたは<br>背面タッチパッドを押して、設定を変更してください。
DrawFilterText - 画面フィルター<pict Arcscash>
DrawFilterUsually - 通常
DrawFilterGrayScale - モノクロ
DrawFilterSepia - セピア
DrawFilterFading - ビンテージ
DrawFilter8bit - ドット
DrawFilter - 画面に適用するフィルターを選択してください。
DrawFilterMessageText - 「プレミアムセット」の有効期間中のみご利用いただけます。<br>画面フィルターを以下から選択してください。
xx_DrawFilterMessageText - 「プレミアムセット」の有効期間中のみご利用いただけます。<br>画面フィルターを以下から選択してください。
cc_DrawFilterMessageText - 「プレミアムセット」の有効期間中のみご利用いただけます。<br>画面フィルターを以下から選択してください。
DrawFilterMessagePremiumOn - <yellow>プレミアム有効期間中<c>
DrawFilterMessagePremiumOff - <red>プレミアム有効期限切れ<c>
DetailPolluteOthers - -
AuraSlider_Text_0 - 透明度
AuraSlider_Text_1 - -
CtrlFuncNameOpenTotalScoreBoost - クエスト連動ブースト
CtrlFuncNameStartChatGroup - グループチャット起動
Title_DetailInfo - 詳細情報
FloatTextItemVita - ドロップアイテムの取得表示
Config_Padinput01 - ゲームパッドの入力形式
Config_Padinput02 - <%GamePad>の振動
Config_Padinput03 - 非アクティブ時のゲームパッド操作
Config_Padinput01_Select01 - DirectInput
Config_Padinput01_Select02 - XInput
Config_Padinput02_Select01 - 振動する
Config_Padinput02_Select02 - 振動しない
Config_Padinput03_Select01 - 操作する
Config_Padinput03_Select02 - 操作しない
Config_PadInput04 - ゲームパッドの入力形式選択
Config_PadInput05 - ゲームパッドのタイプに合わせて入力形式を選択します。<br><yellow>※“XInput”に変更して、正常に動作しなくなった場合は、<br>　キーボードやマウスで“DirectInput”に戻してください。<c>
Config_PadInput06 - <%GamePad>の振動設定
Config_PadInput07 - “XInput”選択時にのみ、振動機能が設定できます。<br>※<%GamePad>によっては、振動しない場合があります。
Config_PadInput07_PS4 - <yellow>※コントローラーによっては、振動しない場合があります。<c>
Config_PadInput12 - 非アクティブ時のゲームパッド操作設定
Config_PadInput13 - ゲーム画面がアクティブになっていない時に、<br>ゲームパッドの入力を受け付けるかを設定します。
Config_PadInput17 - ゲームパッドの初期設定
Config_PadInput18 - “DirectInput”選択時にのみ、初期設定（キャリブレーション）が行えます。

Group 1
Title - Options
Category_Game - Game Settings
Category_Game_Hint - Settings related to gameplay functions and camera control.
Category_Device - Control Settings
Category_Device_Hint - Settings related to input devices such as a keyboard, mouse,<br>or <%GamePad>.
Category_Sound - Audio Settings
Category_Sound_Hint - Setings related to sound.
Category_Graphics - Graphics Settings
Category_Graphics_Hint - Setings related to graphics.
SubCategory_GameFunction - Settings
SubCategory_GameFunction_Hint - Settings related to various game functions.
SubCategory_Camera - Camera Settings
SubCategory_Camera_VITA - In-Game Camera Settings
SubCategory_Camera_Hint - Setings related to camera movement.
SubCategory_TextEffect - Text Display Settings
SubCategory_TextEffect_Hint - Settings related to the text that displays for damage, item<br>acquisition, etc.
SubCategory_Notice - Notification Settings
SubCategory_Notice_Hint - Settings related to various game notifications.
SubCategory_Talk - Chat Settings
SubCategory_Talk_Hint - Setings related to the chat system.
SubCategory_Capture - Screen Capture Settings
SubCategory_Capture_Hint - Setings related to screenshots.
SubCategory_Other - Other Settings
SubCategory_Other_Hint - Setings related to systems such as the salon, Ridroid, Dark<br>Blast, etc.
SubCategory_InputGuide - Control Display Type
SubCategory_InputGuide_Hint - Settings for the display type of the in-game guide.
SubCategory_PadDefine - Default Controller Settings
SubCategory_PadDefine_Hint - Return controller to default settings.
SubCategory_KeyBind_Pad - Keybind Settings (<%GamePad>)
SubCategory_KeyBind_Pad_Hint - Assign functions for <%GamePad> inputs.
SubCategory_KeyBind_Mouse - Keybind Settings (Mouse)
SubCategory_KeyBind_Mouse_Hint - Assign functions for mouse inputs.
SubCategory_KeyBind_Keyboard - Keybind Settings (Keyboard)
SubCategory_KeyBind_Keyboard_Hint - Assign functions for keyboard inputs.
SubCategory_MainInputDevice - Primary Control Device
SubCategory_MainInputDevice_Hint - Select your primary control device.
SubCategory_ActionType - Action Type Settings
SubCategory_ActionType_Hint - Select Action Type.
SubCategory_SoundVolume - Volume
SubCategory_SoundVolume_Hint - Adjust the volume of background music and sound effects.
SubCategory_SoundFunction - Playback Settings
SubCategory_SoundFunction_Hint - Setings related to sound playback.
SubCategory_GraphicsFunction - Graphics Features
SubCategory_GraphicsFunction_Hint - Setings related to graphics.
SubCategory_GraphicsQuality - Display Quality
SubCategory_GraphicsQuality_Hint - Set display quality.
SubCategory_FilterView - Screen Filters <pict Arcscash>
SubCategory_FilterView_Hint - Set screen filters.
SubCategory_ResetWindow - Window Initialization
SubCategory_ResetWindow_Hint - Window display sizes and positions initialized.
SubCategory_GraphicsPreset - Simple Graphics Settings
SubCategory_GraphicsPreset_Hint - Adjusts overall graphics settings. Setting it to a high<br>value will improve the graphical quality but also<br>increase the processing load.
GraphicsPreset_Info - Adjusts overall graphics settings. Setting it to a high value<br>will improve the graphic quality but also increase the<br>processing load.<br><br>Your recommended setting is <yellow>$(0)<c>.
GraphicsPreset_Info_CS - Adjusts overall graphics settings. Setting it to a high<br>value will improve the graphical quality but also<br>increase the processing load.
GraphicsPreset_Button_Change - Change
GraphicsPreset_Button_Cancel - Cancel
GraphicsPreset_choice_1 - 1. Lowest
GraphicsPreset_choice_2 - 2: Low
GraphicsPreset_choice_3 - 3: Medium
GraphicsPreset_choice_4 - 4: High
GraphicsPreset_choice_5 - 5: Super
GraphicsPreset_choice_6 - 6: Ultra
GraphicsPreset_choice_1_CS - 1: Prioritize Frame Rate
GraphicsPreset_choice_2_CS - 2: Balanced
GraphicsPreset_choice_3_CS - 3: Prioritize Graphics
LogoutGuide_Title - Applying Settings
LogoutGuide_Message - Some of your graphics settings will be applied next time<br>you log in.<br><br>Logout now?
LogoutGuide_Message_CantLogout - Some of your graphics settings will be applied next time<br>you log in.
MenuTreeBasic - Basic Settings
MenuTreeDirection - Animation Settings
MenuTreeDraw - Graphics Settings
MenuTreeSound - Audio Settings
MenuTreeControl - Control Settings
MenuTreeCommunication - Communication
MenuTreeSystem - System
MenuButtonBasic - Basic Settings
MenuButtonNotice - Notification Settings
MenuButtonCamera - Camera Settings
MenuButtonCamera_v - In-Game Camera Settings
MenuButtonShoot - Screen Capture Settings
MenuButtonChat - Chat Settings
MenuButtonDirection - Animation Settings
MenuButtonDrawFunction - Graphics Features
MenuButtonDrawFilter - Screen Filters <pict Arcscash>
MenuButtonDrawShadow - Shading Settings
MenuButtonDrawDisplay - Display Settings
MenuButtonSound - Audio Settings
MenuButtonOperationType - Primary Control Device
MenuButtonActionType - Action Type Settings
MenuButtonSndVolume - Volume
MenuButtonSndPlay - Playback Settings
MenuButtonCtrl - Control Settings
MenuButtonWindow - Window Initialization
MenuButtonSystem - System
MenuButtonReset - Restore Default Settings
MenuButtonExit - Discard Changes & Return
MenuButtonExitWithSave - Apply Changes & Return
ThreeChoiceMenuTitle - Confirm Exit
ThreeChoiceMenuMessageApply - Closing the Options screen and returning.<br>Do you wish to save your changes?
ThreeChoiceMenuButtonExit - Discard Changes & Return
ThreeChoiceMenuButtonExitWithSave - Apply Changes & Return
ThreeChoiceMenuButtonCancel - Cancel
ConfirmTitleInit - Confirm Reset to Default Settings
ConfirmMessageInit - All control settings will be reset to their default settings.<br>Are you sure you wish to proceed?
ConfirmTitle - Confirm Exit
ConfirmMessageApply - Your changes will be applied.<br>Are you sure you wish to proceed?
ConfirmMessageDisapply - Your changes will be discarded.<br>Are you sure you wish to proceed?
ConfirmButtonApply - Save Changes & Exit
ConfirmButtonDisapply - Discard Changes & Exit
ConfirmButtonCancel - Return to Options
BasicTextSmutFilter - Text Filtering
VitaCtrlTextSwapLR - Swap L/R button functions (invalid for custom setups)
VitaCtrlTextSwapStartSelect - Swap Start/Select button functions (invalid for custom setups)
VitaCtrlTextNormalCtrlType - Standard View Controls
VitaCtrlTextShoulderCtrlType - Over-the-Shoulder View Controls
VitaCtrlTextSavePartySetting - Save Party Settings
VitaCtrlTextLockonChange - Switch Lock-On Target Using <%RStick>
VitaCtrlTextNavi - Toggle Navigation Icon Display
MltPtMatchingButton - Select initial cursor position when accepting quests that support multi-block matchmaking.<br>*Does not apply to some quests
ConfirmTitleWindowInit - Confirm Window Initialization
ConfirmMessageWindowInit - All window display sizes and positions will be reset.<br>Are you sure you wish to proceed?
ConfirmMessageWindowInitEnd - Window display sizes and positions initialized.
WindowTitleInitText - Window Initialization Settings
WindowInitHint - Window display sizes and positions initialized.
WindowRadioButtonInitText - Initialize all window display sizes and positions
EstheTitleText - Hairstyle, Head Parts, & Accessory Selection Format
EstheHint - Select the type of windows used to display<br>hairstyles, Head Parts, and accessories selectable<br>during character creation and in the Salon.
EstheRadioButtonText1 - Small windows (multiple views can be displayed)
EstheRadioButtonText2 - Large, tabbed window (multiple views cannot be displayed)
CtrlKeyboardTitle - Keyboard Control Settings
CtrlTabTitleNView - Standard
CtrlTabTitleZView - OTS View
CtrlTabTitleWindow - Window
CtrlTabTitleOther - Other
CtrlTabTitleShortcut - Shortcuts
CtrlTabTitleAction - Actions
CtrlTabTitleLobbyAction - Emotes
CtrlTabTitleBasicSet - Basic Settings
CtrlMainCtgNameNView - Standard View Controls
CtrlMainCtgNameZView - Over-the-Shoulder View Controls
CtrlMainCtgNameWindow - Window Controls
CtrlMainCtgNameOther - Other Controls
CtrlMainCtgNameShortcut - Shortcut Controls
CtrlMainCtgNameAction - Action Controls
CtrlMainCtgNameLobbyAction - Emote Controls
CtrlSubCtgNameViewMove - Character Movement
CtrlSubCtgNameViewCamera - Change Camera Distance
CtrlSubCtgNameViewAction - Actions
CtrlSubCtgNameViewActionSupport - Action Support
CtrlSubCtgNameViewMenu - Menus
CtrlSubCtgNameViewPalette - Cycle Weapon Palettes
CtrlSubCtgNameViewChat - Chat
CtrlSubCtgNameViewSubPalette - Call Up Sub-Palette
CtrlSubCtgNameViewMap - Show Map
CtrlSubCtgNameWindowBasic - Confirm/Cancel
CtrlSubCtgNameWindowChat - Chat
CtrlSubCtgNameWindowPage - Change Pages
CtrlSubCtgNameWindowTab - Change Tabs
CtrlSubCtgNameWindowDetailTab - Change Tabs in Details Window
CtrlSubCtgNameWindowCtrlWindow - Change Control Window
CtrlSubCtgNameOtherShortcut - Shortcuts
CtrlSubCtgNameOtherShortcutWord - Chat Shortcuts
CtrlSubCtgNameOtherMainPalette - Change Weapon Palettes Directly
CtrlSubCtgNameOtherSubPalette - Call Up Sub-Palette
CtrlSubCtgNameCtrlCtrl - Shortcut Settings
CtrlSubCtgNameCtrlWindow - Window Shortcut Settings
CtrlSubCtgNameBasic - Basic Controls
CtrlSubCtgNameAssist - Supplemental Controls
CtrlSubCtgNameLobbyAction - Emote Key Settings
CtrlSubCtgNameActionMenu - Action/Menu Controls
CtrlPresetNameRNViewRcm - Recommended Setup for Right-Handed Standard View
CtrlPresetNameRZViewRcm - Recommended Setup for Right-Handed Over-the-Shoulder View
CtrlPresetNameRNViewKbd - Right-Handed Standard View, Keyboard Only
CtrlPresetNameRZViewKbd - Right-Handed Over-the-Shoulder View, Keyboard Only
CtrlPresetNameLNViewRcm - Recommended Setup for Left-Handed Standard View
CtrlPresetNameLZViewRcm - Recommend Setup for Left-Handed Over-the-Shoulder View
CtrlPresetNameLNViewKbd - Left-Handed Standard View, Keyboard Only
CtrlPresetNameLZViewKbd - Left-Handed Over-the-Shoulder View, Keyboard Only
CtrlPresetNameRcm1 - Recommended Setup 1
CtrlPresetNameRcm2 - Recommended Setup 2
CtrlPresetNameNViewRcm1 - Standard View Recommended Setup 1
CtrlPresetNameNViewRcm2 - Standard View Recommended Setup 2
CtrlPresetNameZViewRcm1 - Over-the-Shoulder View Recommended Setup 1
CtrlPresetNameZViewRcm2 - Over-the-Shoulder View Recommended Setup 2
CtrlPresetNameRRcm - Right-Handed Recommended Setup
CtrlPresetNameLRcm - Left-Handed Recommended Setup
CtrlPresetNameCutom - Custom
CtrlPresetNameRcm - Recommended Setup
CtrlAssignNameMouseL - Left Click
CtrlAssignNameMouseR - Right Click
CtrlAssignNameMouseM - Wheel Click
CtrlAssignNameMouseWheel - Wheel
CtrlAssignNameMouseX1 - Side Button (X1)
CtrlAssignNameMouseX2 - Side Button (X2)
CtrlFuncNameNone - None
CtrlFuncNameMoveForward - Move Forward
CtrlFuncNameMoveRight - Move Right
CtrlFuncNameMoveLeft - Move Left
CtrlFuncNameMoveBack - Move Back
CtrlFuncNameNormalAttack - Normal Attack
CtrlFuncNamePhotonArts - Photon Arts/Techniques
CtrlFuncNameAvoid - Dodge Action
CtrlFuncNameJump - Jump
CtrlFuncNameAccess - Access
CtrlFuncNameWeponAction - Weapon Action
CtrlFuncNameLockon - Lock-on
CtrlFuncNameLockonNext - Switch Targets
CtrlFuncNameChangeView - Switch Views
CtrlFuncNameCameraDistance - Change Camera Distance
CtrlFuncNameCameraSelect - Select Camera
CtrlFuncNameCameraLightSetting - Custom Lighting Settings
CtrlFuncNameCameraMoveUD - Move Camera Up/Down
CtrlFuncNameAutoRun - Auto-Run
CtrlFuncNameRefuseFollowRun - Stop Auto-Follow
CtrlFuncNameOpenMainMenu - Main Menu
CtrlFuncNameOpenSelectMenu - Quick Menu
CtrlFuncNameOpenEquip - Equipment
CtrlFuncNameOpenPlayerList - Nearby Characters
CtrlFuncNameMainPaletteForward - Cycle Weapon Palettes
CtrlFuncNameMainPaletteBack - Cycle Weapon Palettes (Rev.)
CtrlFuncNameMainPaletteA - Action 1
CtrlFuncNameMainPaletteB - Action 2
CtrlFuncNameMainPaletteC - Action 3
CtrlFuncNameBackPallete - Change Back Palette
CtrlFuncNameMainPaletteUp - Cycle Weapon Palettes Down
CtrlFuncNameMainPaletteDown - Cycle Weapon Palettes Up
CtrlFuncNameStartChat - Begin Chat
CtrlFuncNameStartChatPublic - Begin Area Chat
CtrlFuncNameStartChatParty - Begin Party Chat
CtrlFuncNameStartChatGuild - Begin Alliance Chat
CtrlFuncNameStartChatWhisper - Begin Whisper Chat
CtrlFuncNameSubpaletteChange - Move Sub-Palette Cursor
CtrlFuncNameSubpalette - Call Up Sub-Palette
CtrlFuncNameSubpaletteForward - Cycle Sub-Palettes
CtrlFuncNameSubpaletteLeft - Sub-Palette Cursor Left
CtrlFuncNameSubpaletteRight - Sub-Palette Cursor Right
CtrlFuncNameCameraNear - Approach Character
CtrlFuncNameCameraFar - Move Away from Character
CtrlFuncNameCameraUp - Move Up
CtrlFuncNameCameraDown - Move Down
CtrlFuncNameCameraNext - Next Camera Selection
CtrlFuncNameCameraPrev - Previous Camera Selection
CtrlFuncNameUseCameraLight1 - Use Lighting 1
CtrlFuncNameUseCameraLight2 - Use Lighting 2
CtrlFuncNameUseCameraLight3 - Use Lighting 3
CtrlFuncNameUseDeafultCameraLight - Use Standard Lighting
CtrlFuncNameScreenShoot - Take Screenshot
CtrlFuncNameMovie - Capture Video
CtrlFuncNameDecide - Confirm
CtrlFuncNameCancel - Cancel
CtrlFuncNameChangeMouseMode - Switch Mouse Mode
CtrlFuncNameAllWindowClose - Close Main Menu
CtrlFuncNameMultiSelect - Select Multiple
CtrlFuncNameFunction - Expand Functions
CtrlFuncNameMove - Move Between Selections
CtrlFuncNamePageForward - Next Page
CtrlFuncNamePageBack - Previous Page
CtrlFuncNameTabForward - Next Tab
CtrlFuncNameTabBack - Previous Tab
CtrlFuncNameWindowTabForward - Next Tab in Details Window
CtrlFuncNameWindowTabBack - Previous Tab in Details Window
CtrlFuncNameChangeWindow - Change Control Window
CtrlFuncNameCtrlTabForward - Next Control Window
CtrlFuncNameCtrlTabBack - Previous Control Window
CtrlFuncNameCtrlException - Special Controls
CtrlFuncNameCtrlException02 - Special Controls 2
CtrlFuncNameStctWord - Run Chat Shortcuts
CtrlFuncNameChangeToMainPalette - Switch Palettes
CtrlFuncNameChangeRadarMap - Toggle Radar Map
CtrlFuncNameChangeAreaMap - Toggle Region and City Map
CtrlFuncNameOpenItemPack - Item
CtrlFuncNameOpenCustomize - Custom
CtrlFuncNameOpenMag - Mags
CtrlFuncNameOpenPet - Pets
CtrlFuncNameOpenEventItem - Event Items
CtrlFuncNameOpenEquipWeapon - Equip Weapons
CtrlFuncNameOpenEquipArmor - Equip Armor
CtrlFuncNameOpenSubpalette - Edit Sub-Palettes
CtrlFuncNameOpenFriend - Friend List
CtrlFuncNameOpenGuild - Alliance Commands
CtrlFuncNameOpenParty - Party Commands
CtrlFuncNameOpenMail - Mail
CtrlFuncNameOpenNearCharacter - Nearby Characters
CtrlFuncNameOpenCharaInfo - Character Info
CtrlFuncNameOpenLicense - Titles
CtrlFuncNameOpenMyMenu - Quick Menu
CtrlFuncNameOpenCommunicationLog - Communications Log
CtrlFuncNameOpenProfile - ARKS ID Info
CtrlFuncNameOpenLibrary - Compendium
CtrlFuncNameOpenMutterBoard - Storyboard (Ep. 4)
CtrlFuncNameOpenClientOrder - Client Orders
CtrlFuncNameOpenQuestInfo - Quest Info
CtrlFuncNameOpenSymbolArt - Symbol Art
CtrlFuncNameOpenMacro - Chat Settings
CtrlFuncNameOpenConfig - Options
CtrlFuncNameOpenPayShop - Shop Menu
CtrlFuncNameOpenACGacha - Play Scratch Tickets
CtrlFuncNameOpenPayLog - Purchase History
CtrlFuncNameOpenRentalLimit - Rental Expiration
CtrlFuncNameOpenLogOut - Log Out
CtrlFuncNameOpenBingo - ARKS Bingo
CtrlFuncNameOpenInformation - Information
CtrlFuncNameOpenArksRoad - ARKS Training
CtrlFuncNameOpenCraftAchievement - Crafting Achiev.
CtrlFuncNameOpenShipBattle - ARKS Ship Competitions
CtrlFuncNameOpenRecycle - Swap Shop
CtrlFuncNameOpenFashion - Customize Looks
CtrlFuncNameOpenGatStatus - Gathering Status
CtrlFuncNameOpenGatAchieve - Available Gathering Achievements
CtrlFuncNameOpenEquipNote - Collection Folder
CtrlFuncNameOpenBuySG - Purchase Star Gems
CtrlFuncNameOpenPokaRecord - Battle Results Info
CtrlFuncNameOpenPokaRankMatch - Battle Rank Info
CtrlFuncNameOpenPokaRankMatch_Switch - Battle Rank Info (Cloud Ver.)
CtrlFuncNameOpenFashionCat - Lookbook
CtrlFuncNameOpenArksLeague - ARKS Leagues
CtrlFuncNameOpenBasnetContentInfo - Buster Quest Info
CtrlFuncNameOpenPolluteEdit - Dark Blasts
CtrlFuncNameOpenSgShop - SG Shop
CtrlFuncNameOpenArksContract - ARKS Missions
CtrlFuncNameOpenWebLink - Web Link Events
CtrlFuncNameOpenWorldmap - World Map
CtrlFuncNameMuteVoiceChat - Toggle Mic Mute
CtrlFuncNameWinShortcut - Window Shortcuts
CtrlFuncNameWinShortcutT1 - 1
CtrlFuncNameWinShortcutT2 - 2
CtrlFuncNameWinShortcutT3 - 3
CtrlFuncNameWinShortcutT4 - 4
CtrlFuncNameWinShortcutT5 - 5
CtrlFuncNameWinShortcutT6 - 6
CtrlFuncNameWinShortcutT7 - 7
CtrlFuncNameWinShortcutT8 - 8
CtrlFuncNameWinShortcutT9 - 9
CtrlFuncNameWinShortcutT10 - 0
CtrlFuncNameWinShortcutF1 - F1
CtrlFuncNameWinShortcutF2 - F2
CtrlFuncNameWinShortcutF3 - F3
CtrlFuncNameWinShortcutF4 - F4
CtrlFuncNameWinShortcutF5 - F5
CtrlFuncNameWinShortcutF6 - F6
CtrlFuncNameWinShortcutF7 - F7
CtrlFuncNameWinShortcutF8 - F8
CtrlFuncNameWinShortcutF9 - F9
CtrlFuncNameWinShortcutF10 - F10
CtrlFuncNameWinShortcutN1 - NumPad 1
CtrlFuncNameWinShortcutN2 - NumPad 2
CtrlFuncNameWinShortcutN3 - NumPad 3
CtrlFuncNameWinShortcutN4 - NumPad 4
CtrlFuncNameWinShortcutN5 - NumPad 5
CtrlFuncNameWinShortcutN6 - NumPad 6
CtrlFuncNameWinShortcutN7 - NumPad 7
CtrlFuncNameWinShortcutN8 - NumPad 8
CtrlFuncNameWinShortcutN9 - NumPad 9
CtrlFuncNameWinShortcutN10 - NumPad 0
CtrlLobbyActionAssignName - Alt + $(0)
CtrlAssignButtonInput - Set
CtrlAssignButtonWaiting - Wait
CtrlAssignHint - Press a key or button.<br>(Press the [Esc] key to cancel.)
CtrlCtrlAssignTypeT - 1 to 0
CtrlCtrlAssignTypeF - F1 to F10
CtrlCtrlAssignTypeN - NumPad 1 to NumPad 0
CtrlCtrlAssignTypeCtrlT - Ctrl+1 to Ctrl+0
CtrlCtrlAssignTypeCtrlF - Ctrl+F1 to F10
CtrlCtrlAssignTypeCtrlN - Ctrl+NumPad 1 to 0
CtrlCtrlSwapMessage - Replaced with "$(0)."
CtrlCtrlCaptionFuncName - Function Name
CtrlCtrlCaptionAssign - Current Settings
CtrlPartition -  / 
CtrlVitaAccessEscape - <pict Sign_L3> + <pict Sign_CIRCLE>
CtrlVitaPalletinfo - Limit cycling between Weapon Palettes
CtrlVitaSubPalletinfo - Limit cycling between Sub-Palettes
CtrlAnnounceTitle - Select Control Display Type
CtrlAnnounceMessage - Select how you would like keys and buttons<br>to be represented in control descriptions.
CtrlAnnounceSelSymbol - Symbols
CtrlAnnounceSelAlphabet - Letters
CtrlAnnounceSelNumber - Numbers
CtrlAnnounceSelKeyboard - Keyboard
CtrlAnnounceExample - Samples:
CtrlAnnounceExampleKey - <pict Key_ENTER> [Esc] [↑] <pict Key_SPACE>
CtrlAnnounceExampleAlpha - <pict Alpha_A><pict 4space><pict Alpha_B><pict 4space><pict Alpha_RB><pict 4space><pict Alpha_UP>
CtrlAnnounceExampleSign - <pict Sign_CIRCLE><pict 4space><pict Sign_CROSS><pict 4space><pict Sign_R1><pict 4space><pict Sign_UP>
CtrlAnnounceExampleNumber - <pict Number_1><pict 4space><pict Number_2><pict 4space><pict Number_5><pict 4space><pict Number_UP>
CtrlAnnounceHint - Undefined
CtrlPadBehaviorTitle - Default Controller Settings
CtrlPadBehaviorSetting - Configure Manually
CtrlPadBehaviorInitialize - Configure Automatically
CtrlPadBehaviorStickTitle - Analog Stick Movement Settings
CtrlPadBehaviorStickPrepare - The analog sticks will now be calibrated.<br>Press [Close] without touching the sticks.
CtrlPadBehaviorStickSubTitleLU - 1. <%LStick> "Up" Detection Test
CtrlPadBehaviorStickMessageLU - Perform a <%LStick> movement detection test.<br>Tilt the <%LStick> <c ff007f>up<c> while pressing $(0).<br><br><yellow>*If there is no response, search your devices for a button<br>marked  <c ff007f>"Analog"<c><yellow> or <c ff007f>"Mode"<c><yellow><br>and press it to switch to analog mode.<c>
CtrlPadBehaviorStickSubTitleLL - 2. <%LStick> "Left" Detection Test
CtrlPadBehaviorStickMessageLL - Next,<br>tilt the <%LStick> <green>left<c> while pressing $(0).
CtrlPadBehaviorStickSubTitleRU - 3. "Up" Detection Test
CtrlPadBehaviorStickMessageRU - The <%LStick> detection test is complete.<br><br>Next, we'll perform a test for detecting <%RStick> movement.<br>Tilt the <%RStick> <c ff007f>up<c> while pressing $(0).
CtrlPadBehaviorStickSubTitleRL - 4. <%RStick> "Left" Detection Test
CtrlPadBehaviorStickMessageRL - Next,<br>tilt the <%RStick> <green>left<c> while pressing $(0).
CtrlPadBehaviorTriggerTitle - Trigger Operation
CtrlPadBehaviorTriggerMessageL - Perform a test to detect whether the left button on the back of the controller is an analog trigger.<br>Press the button that is lit up on the diagram below.<br><br><yellow>If nothing happens when you press the designated button, then it is not an analog trigger.<br>In that case, press <c>$(0)<yellow>, then configure the button in the next screen.<c>
CtrlPadBehaviorTriggerMessageR - Perform a test to detect whether the right button on the back of the controller is an analog trigger.<br>Press the button that is lit up on the diagram below.<br><br><yellow>If nothing happens when you press the designated button, then it is not an analog trigger.<br>In that case, press <c>$(0)<yellow>, then configure the button in the next screen.<c>
CtrlPadBehaviorConfirmInitTitle - Restore Default Settings
CtrlPadBehaviorConfirmApplyTitle - Update Settings
CtrlPadBehaviorConfirmInitMessage - Restore settings to their default values.
CtrlPadBehaviorConfirmApplyMessage - Apply changes to settings.
CtrlPadBehaviorHelpSetting - Detect controller sticks & triggers<br>and configure button assignments.
CtrlPadBehaviorHelpInitialize - Default to the recommended settings for your controller.
CtrlPadBehaviorHelpInitializeDisable - This controller does not support automatic configuration.
CtrlPadBehaviorHelpTrigger - Configure controller triggers.
CtrlPadBehaviorButtonDefTitle - Button Display Settings
CtrlPadBehaviorButtonDefMessage2 - Lastly, we will assign the button icons that appear in-game to the buttons on your controller.<br><br>Go down the list in order, select "Change" as appropriate, then press the controller<br>button that corresponds to the one shown in the <c ff007f>Button Display<c>.
CtrlPadBehaviorButtonDefCaptionDef - <c ff007f>Button Display<c>
CtrlPadBehaviorButtonDefCaptionAssign - Assign Buttons
CtrlPadBehaviorButtonDefApply - Apply Changes & Return
CtrlPadBehaviorButtonDefDisapply - Discard Changes & Return
CtrlPadBehaviorButtonDefMessage - Press the button to use for $(0).
CtrlPadBehaviorButtonDefDisable - <gray>Setting not required (analog).<c>
CtrlPadCtrlTitle - Controller Operation
CtrlPadInitToast - Controller operation have been automatically configured. You can also manually configure your gamepad under "Default Controller Settings."
RadioButtonEnable - Enable
RadioButtonDisable - Disable
RadioButtonShow - Display
RadioButtonHide - Hide
RadioButtonAllow - Send
RadioButtonDisallow - Don't Send
RadioButtonCtrlNormal - Normal
RadioButtonCtrlCustom - Custom (<pict Sign_TRIANGLE>: change custom settings)
RadioButtonCtrlType1 - Type 1
RadioButtonCtrlType2 - Type 2
RadioButtonCtrlType3 - Type 3
RadioButtonSave - Save
RadioButtonNotSave - Don't save
RadioButtonButtonResetOn - Display
RadioButtonButtonResetOff - Hide
Number0 - 0
Number50 - 50
Number100 - 100
VITA_CustomWindow - <pict Sign_TRIANGLE>Change Custom Settings
VITA_CustomTitle - Custom Settings
VITA_PushButton - Button Input
VITA_CustomToast1 - Custom Settings have been changed. All control setups can be implemented via the "Custom" option.
VITA_CustomToast2 - Important control operations have not been assigned.
VITA_AutoRun - Auto-Run/Switch Sub-Palette (Left)
VITA_ChangeView - Change View/Switch Sub-Palette (Right)
VITA_CustomInfo - In Custom Settings, you can configure not only the buttons but the upper-left<pict Sign_BACK_L> <br>and upper-right <pict Sign_BACK_R> sections of the touchpad.<br><br>Select a function you would like to reconfigure and press the button or area of the touchpad you<br>would like to use to control it to change the settings.
DrawFilterText - Screen Filters <pict Arcscash>
DrawFilterUsually - Normal
DrawFilterGrayScale - Monochrome
DrawFilterSepia - Sepia
DrawFilterFading - Vintage
DrawFilter8bit - Pixel
DrawFilter - Select a filter to apply.
DrawFilterMessageText - This feature is available only with the purchase of a valid Premium Set.<br>Select the screen filter you would like to use from the list below.
xx_DrawFilterMessageText - This feature is available only with the purchase of a valid Premium Set.<br>Select the screen filter you would like to use from the list below.
cc_DrawFilterMessageText - This feature is available only with the purchase of a valid Premium Set.<br>Select the screen filter you would like to use from the list below.
DrawFilterMessagePremiumOn - <yellow>Premium Status in good standing<c>
DrawFilterMessagePremiumOff - <red>Premium Status has expired<c>
DetailPolluteOthers - -
AuraSlider_Text_0 - Transparency
AuraSlider_Text_1 - -
CtrlFuncNameOpenTotalScoreBoost - Quest Link Boost
CtrlFuncNameStartChatGroup - Launch Group Chat
Title_DetailInfo - Detailed Information
Config_Padinput01 - Gamepad Input Type
Config_Padinput02 - <%GamePad> Vibration
Config_Padinput03 - Inactive Gamepad Control
Config_Padinput01_Select01 - DirectInput
Config_Padinput01_Select02 - XInput
Config_Padinput02_Select01 - Vibration On
Config_Padinput02_Select02 - Vibration Off
Config_Padinput03_Select01 - Enable
Config_Padinput03_Select02 - Disable
Config_PadInput04 - Gamepad Input Type Selection
Config_PadInput05 - Select the input method according to the gamepad.<br><yellow>Note: If "XInput" does not work properly, change it back to "DirectInput"<br>using the keyboard or mouse.<c>
Config_PadInput06 - Toggle <%GamePad> Vibration
Config_PadInput07 - Vibration only available when XInput is selected.<br>Note: Certain <%GamePad> may not support vibration.
Config_PadInput07_PS4 - <yellow>Note: Certain <%GamePad> may not support vibration.<c>
Config_PadInput12 - Inactive Gamepad Control
Config_PadInput13 - Set whether gamepad inputs are accepted<br>when the application is inactive.
Config_PadInput17 - Default Gamepad Settings
Config_PadInput18 - Initial settings (calibration) can be made only when "DirectInput" is selected.


ConfigContents
Group 0
Subject_000 - アクション機能設定
Subject_001 - HUD設定
Subject_002 - メニュー設定
Subject_003 - ドロップアイテム自動取得機能
Subject_004 - その他の設定
Subject_005 - カメラ設定
Subject_006 - カメラ左右回転速度
Subject_007 - カメラ上下回転速度
Subject_008 - 与ダメージ表示
Subject_009 - 回復／被ダメージ表示
Subject_010 - EXPなどの表示
Subject_011 - ドロップアイテムの取得表示
Subject_012 - 確認通知
Subject_013 - メッセージ通知
Subject_014 - その他の通知
Subject_015 - 会話設定
Subject_016 - 他者のオートワード表示設定
Subject_017 - ログウィンドウの「すべて表示」に表示するチャンネル
Subject_018 - スクリーンショット設定
Subject_019 - エステ設定
Subject_020 - ライドロイド設定
Subject_021 - ダークブラスト設定
Subject_022 - BGM音量
Subject_023 - SE音量
Subject_024 - ボイス音量
Subject_025 - ゲーム内再生動画音量
Subject_026 - 再生機能
Subject_027 - 描画機能
Subject_028 - 詳細に描写するキャラクター表示数
Subject_029 - フォトンブラスト表示数
Subject_030 - 映り込み品質
Subject_031 - 影品質
Subject_032 - 画面の明るさ
Subject_033 - カメラライト
Subject_034 - マウス使用時補正
Subject_035 - ボイスチャット機能ON/OFF
Subject_036 - ウィッシュリスト、プレゼントリスト
Config_000_Name - ロックオンの切り替え
Config_000_Choices_0 - ワンプッシュ
Config_000_Choices_1 - ホールド
Config_000_Hint - ロックオン操作で、<br>ボタンやキーを押すたびに<br>ロックオンのON/OFFを切り替えるか、<br>押している間のみロックオンするかを選択します。
Config_001_Name - <%RStick>によるロックオン対象の切り替え
Config_001_Choices_0 - 使用する
Config_001_Choices_1 - 使用しない
Config_001_Hint - ロックオン中に、<br><%RStick>で対象を切り替える機能を<br>使用するかを設定します。
Config_002_Name - 裏パレットの切り替え
Config_002_Hint - 裏パレットの切り替え操作で、<br>ボタンやキーを押すたびに切り替えるか、<br>押している間のみ切り替えるかを選択します。
Config_003_Name - 回避操作の移動キー２回押し間隔
Config_003_Choices_0 - 長間隔
Config_003_Choices_1 - 中間隔
Config_003_Choices_2 - 短間隔
Config_003_Choices_3 - ２回押し無効
Config_003_Hint - キーボードのキャラクター移動キー<br>（初期設定で[W]/[A]/[S]/[D]キー）を<br>２回押しして、“回避アクション”をする時の<br>入力受け付け間隔を設定します。
Config_004_Name - レーダーマップの回転
Config_004_Choices_0 - 回転しない
Config_004_Choices_1 - 回転する
Config_004_Hint - レーダーマップを、カメラの向きに合わせて<br>回転させるかを設定します。
Config_005_Name - Eトライアル発生時のマップ切り替え
Config_005_Choices_0 - 広域表示に切り替え
Config_005_Choices_1 - 切り替えをしない
Config_005_Hint - レーダーマップを拡大表示している時に<br>Ｅトライアルが発生した際、<br>自動で一時的にレーダーマップを広域表示に<br>切り替えるかを設定します。
Config_006_Name - 選択中のサブパレット内容
Config_006_Choices_0 - 表示しない
Config_006_Choices_1 - 切り替え時のみ表示する
Config_006_Choices_2 - 常に表示する
Config_006_Hint - 選択中のサブパレット内容の表示方法を設定します。
Config_007_Name - ペットのパラメーター情報
Config_007_Choices_0 - 表示する
Config_007_Choices_1 - 表示しない
Config_007_Hint - ペットのHPバーと状態を表すアイコンを<br>表示させるか設定します。
Config_008_Name - 他パーティーのキャラクター名表示色
Config_008_Choices_0 - 白
Config_008_Choices_1 - 青
Config_008_Hint - 他パーティーのキャラクター名を、<br>何色で表示するかを設定します。
Config_009_Name - 攻撃属性によるHPバーのカラー
Config_009_Choices_0 - 攻撃属性に依存しない
Config_009_Choices_1 - 攻撃属性に依存する
Config_009_Hint - ダメージを受けた際に表示されるHPバーの色を<br>攻撃属性（打撃、射撃、法撃）に依存した色で<br>表示するかしないか設定します。
Config_010_Name - 復帰プレイヤーアイコン
Config_010_Hint - 復帰プレイヤーアイコンを<br>表示するかしないかを設定します。<br>※アイコンを表示しなくても<br>　　各ボーナスは受けられます。
Config_011_Name - 倉庫の初期カーソル位置
Config_011_Choices_0 - すべての倉庫
Config_011_Choices_1 - 基本倉庫
Config_011_Choices_2 - キャラ倉庫
Config_011_Choices_3 - プレミアム倉庫
Config_011_Choices_4 - ＯＴＰ倉庫
Config_011_Choices_5 - PSO2es倉庫
Config_011_Hint - 倉庫端末やマイショップ出品時<br>NPCショップでのアイテム売買において<br>倉庫UIが表示された時の<br>初期カーソル位置を設定します。
Config_012_Name - 簡易ギャザリング情報
Config_012_Hint - メインメニューを表示する時に<br>簡易ギャザリング情報を<br>表示するかしないか設定をします。
Config_013_Name - キャラクターメニューの表示形式
Config_013_Choices_0 - カテゴリー
Config_013_Choices_1 - 一覧
Config_013_Hint - 周囲のキャラクターを選択した時などに表示される<br>キャラクターメニューの形式を設定します。
Config_014_Name - クエストカウンターの表示形式
Config_014_Hint - クエストカウンターの表示形式を設定します。
Config_015_Name - パーティー情報入力メニューの表示形式
Config_015_Choices_0 - 詳細形式
Config_015_Choices_1 - 通常形式
Config_015_Hint - パーティー情報入力メニューの<br>表示形式を設定します。
Config_016_Name - パーティー設定の保存
Config_016_Choices_0 - 保存する
Config_016_Choices_1 - 保存しない
Config_016_Hint - パーティー設定を一時的に保存し、<br>ブロック移動やログアウトを行っても<br>設定を維持するかを設定します。<br><br><yellow>※保存されたパーティー設定は<br>　ゲームを終了するまで有効です。<c><br><br><yellow>※“保存しない”を選択した場合でも、<br>　パスワードの設定はログアウトするまで有効です。<c>
Config_017_Name - クエスト受注時のパーティー名
Config_017_Choices_0 - クエスト名
Config_017_Choices_1 - キャラクター名
Config_017_Hint - パーティー名を入力せずにクエストを受注した時に<br>自動的につけられるパーティー名を選択します。 <br><br>【クエスト名】<br>受注したクエスト名を表示します。<br><br>【キャラクター名】<br>受注したキャラクター名を表示します。
Config_018_Name - クエスト受注時の初期カーソル位置
Config_018_Choices_0 - 複数のブロックを検索
Config_018_Choices_1 - 現在のブロックで受注
Config_018_Hint - 複数ブロックマッチング可能なクエストの受注時<br>カーソル位置をどちらのボタンにするか設定します。<br><br>※一部クエストを除きます。
Config_019_Name - メセタの自動拾い
Config_019_Choices_0 - 使用しない
Config_019_Choices_1 - 使用する
Config_019_Hint - メセタを自動で拾う機能を<br>使用するかしないか設定します。
Config_020_Name - 武器の即時取得
Config_020_Choices_0 - 使用しない
Config_020_Choices_1 - ★13以上で使用
Config_020_Hint - レアリティの高い武器がドロップする際に<br>取得ミスを防ぐため、フィールドにドロップさせず<br>アイテムパックに即時取得するかを設定します。
Config_021_Name - ユニットの即時取得
Config_021_Choices_0 - 使用しない
Config_021_Choices_1 - ★12以上で使用
Config_021_Hint - レアリティの高いユニットがドロップする際に<br>取得ミスを防ぐため、フィールドにドロップさせず<br>アイテムパックに即時取得するかを設定します。
Config_022_Name - 素材アイテムの即時取得
Config_022_Hint - 『オーダーアイテム／素材』カテゴリーの<br>アイテムがドロップする際に<br>取得ミスを防ぐため、フィールドにドロップさせず<br>アイテムパックに即時取得するかを設定します。
Config_023_Name - その他のアイテムの即時取得
Config_023_Hint - 武器、ユニット、素材以外のアイテムを対象として<br>レアリティの高いアイテムがドロップする際に<br>取得ミスを防ぐため、フィールドにドロップさせず<br>アイテムパックに即時取得するかを設定します。
Config_024_Name - レアアイテムのドロップ演出表示
Config_024_Choices_0 - ★7以上
Config_024_Choices_1 - ★10以上
Config_024_Choices_2 - ★13以上
Config_024_Hint - レアアイテムがドロップした際に表示される演出を<br>どのレアリティから表示するか設定します。
Config_025_Name - イベント注目機能
Config_025_Hint - イベント発生時にアクセスボタンをホールドして<br>イベント注目をする機能を使用するか設定します。
Config_026_Name - ゲーム内モニターの動画再生
Config_026_Choices_0 - 再生する
Config_026_Choices_1 - 再生しない
Config_026_Hint - シティなどに設置されたモニターで<br>動画を再生するかを設定します。
Config_027_Name - ビギナーブロック優先ログイン
Config_027_Choices_0 - 優先する
Config_027_Choices_1 - 優先しない
Config_027_Hint - レベル20以下のキャラクターでログインする時、<br>優先的にビギナーブロックへ入るか選択します。
Config_028_Name - フォトンブラスト表示数
Config_028_Choices_0_VITA - 全員分を表示
Config_028_Choices_1_VITA - 自分の分だけを表示
Config_028_Hint_VITA - 他プレイヤーのフォトンブラストを<br>表示するか設定します。
Config_029_Name - マウスによるカメラ操作
Config_029_Choices_0 - カメラ操作を優先
Config_029_Choices_1 - カーソル操作を優先
Config_029_Hint - マウスを操作した時にカメラ操作を優先するか、<br>マウスカーソル操作を優先するかを設定します。
Config_030_Name - カメラ左右回転方向
Config_030_Choices_0 - 標準
Config_030_Choices_1 - 反転
Config_030_Hint - カメラの左右回転方向を設定します。
Config_031_Name - カメラ上下回転方向
Config_031_Hint - カメラの上下回転方向を設定します。
Config_032_Hint - カメラの左右回転の速さを設定します。
Config_033_Hint - カメラの上下回転の速さを設定します。
Config_034_Name - マウスによるカメラ操作
Config_035_Name - カメラ左右回転方向
Config_036_Name - カメラ上下回転方向
Config_039_Name - プレイヤーキャラクター
Config_039_Choices_0 - 大（標準）
Config_039_Choices_1 - 中
Config_039_Choices_2 - 小
Config_039_Choices_3 - 表示しない
Config_039_Hint - ダメージを与えた時に表示される<br>演出のサイズを設定します。
Config_040_Name - パーティーメンバー
Config_041_Name - その他のキャラクター
Config_042_Name - プレイヤーキャラクター
Config_042_Hint - 回復効果やダメージを受けた時に表示される<br>演出のサイズを設定します。
Config_043_Name - パーティーメンバー
Config_044_Name - その他のキャラクター
Config_045_Name - EXP／その他
Config_045_Hint - EXPを獲得した時などに表示される<br>演出のサイズを設定します。
Config_046_Name - アイテムの取得
Config_046_Choices_0 - キャラクター横に表示
Config_046_Choices_1 - アイテムの位置に表示
Config_046_Choices_2 - 表示しない
Config_046_Hint - アイテムを取得した時に表示される<br>演出の表示位置を設定します。
Config_047_Name - パーティーの招待通知
Config_047_Hint - パーティーに招待された時に、<br>新着通知のウィンドウを表示するかを設定します。
Config_048_Name - フレンド登録の通知
Config_048_Hint - フレンド登録を申し込まれた時に、<br>新着通知のウィンドウを表示するかを設定します。
Config_049_Name - チームスカウトの通知
Config_049_Hint - チームにスカウトされた時に、<br>新着通知のウィンドウを表示するかを設定します。
Config_050_Name - グループチャット招待
Config_050_Hint - グループチャットに招待された時、<br>参加選択ウィンドウを表示するかを設定します。
Config_051_Name - トレード申し込み
Config_051_Hint - トレードを提案された時、<br>返答選択ウィンドウを表示するかを設定します。
Config_052_Name - おすすめオーダーの通知
Config_052_Hint - おすすめクエストを受注した時<br>おすすめオーダーの受注メニューを<br>表示するかを設定します。
Config_053_Name - 複数ブロックマッチングの受注確認
Config_053_Hint - パーティーリーダーが複数ブロックマッチングで<br>クエストを受注した時、受注確認のウィンドウを<br>自動で開くかを設定します。
Config_054_Name - <%GamePad>の割り当て通知
Config_054_Hint - <%GamePad>の設定で<br>重要な機能の割り当てに問題があった時に、<br>割り当ての自動修復の通知を<br>受信するかを設定します。
Config_055_Name - 通知メッセージ表示件数
Config_055_Choices_0 - 1件
Config_055_Choices_1 - 3件
Config_055_Hint - 通知メッセージを<br>同時に最大何件まで表示するか設定します。
Config_056_Name - アイテム取得時のログ表示
Config_056_Hint - アイテムを取得した時に、<br>ログに表示するかを設定します。
Config_057_Name - パーティー内のレアアイテム取得通知
Config_057_Hint - パーティーメンバーが<br>レアアイテムを取得した時に、<br>通知をするかを設定します。
Config_058_Name - プレミアムセットの有効期限切れ通知
Config_058_Hint - プレミアムセットの<br>有効期限が切れる７日より前に、<br>ログイン時にその旨を通知するかを設定します。
Config_059_Name - ログインコールの送信
Config_059_Choices_0 - 送る
Config_059_Choices_1 - 送らない
Config_059_Hint - 自分がログインした時に、<br>フレンドにログインコールを送るかを設定します。
Config_060_Name - 他プレイヤーの戦闘不能通知
Config_060_Hint - パーティーメンバーを含め、<br>他プレイヤーの戦闘不能通知を<br>表示するかを設定します。
Config_061_Name - 自分の戦闘不能通知
Config_061_Hint - 自分が戦闘不能になった時に、<br>周囲のプレイヤーに戦闘不能アイコンを<br>表示するかを設定します。<br><br><yellow>※相手側の表示設定がOFFの場合、<br>　相手に戦闘不能アイコンは表示されません。<c>
Config_062_Name - ダイレクトチャット
Config_062_Hint - 「使用する」を選ぶと、キーボードを<br>キャラクター移動などのアクション用ではなく<br>直接チャット入力が出来るように設定します。
Config_063_Name - ダイレクトチャットの切り替えキー
Config_063_Hint - ダイレクトチャットのON/OFFを<br>Scroll Lockキーで切り替えられる機能を<br>使用するかどうか設定します。<br><br>ダイレクトチャットが正しく動作しない場合、<br>この設定をONにすることで、正しく動くように<br>なる可能性があります。
Config_064_Name - メール返信時の引用
Config_064_Choices_0 - 引用する
Config_064_Choices_1 - 引用しない
Config_064_Hint - メール返信時に、引用するかを設定します。
Config_065_Name - シンボルアートの発言表示
Config_065_Hint - シンボルアートの発言を表示するか設定します。
Config_066_Name - チームチャット吹き出し表示
Config_066_Choices_0 - すべて表示する
Config_066_Choices_1 - 同じエリアの発言のみ
Config_066_Choices_2 - 表示しない
Config_066_Hint - チームチャット吹き出しの表示条件を<br>設定します。
Config_067_Name - グループチャット吹き出し表示
Config_067_Hint - グループチャット吹き出しの表示条件を<br>設定します。
Config_068_Name - グループ、チーム、ウィスパーの発言者名
Config_068_Choices_0 - プレイヤーIDネーム
Config_068_Choices_1 - キャラクター名
Config_068_Hint - グループチャット、チームチャット、<br>ウィスパーチャットの発言者名を<br>プレイヤーIDネームとキャラクター名<br>どちらで表示するか設定します。
Config_069_Name - チャット入力欄の背景色
Config_069_Choices_0 - 発言先の色にしない
Config_069_Choices_1 - 発言先の色にする
Config_069_Hint - チャット入力の背景の色を発言先にしたがって<br>変化するようにするか設定します。
Config_070_Name - グループチャットの招待可否
Config_070_Choices_0 - 招待を受ける
Config_070_Choices_1 - 招待を受けない
Config_070_Hint - グループチャットの招待を受けるか設定を行います。<br>受けない設定にした場合、招待が届かなくなります。
Config_071_Name - オートワードの使用
Config_071_Hint - オートワードを使用するかを設定します。<br><br><yellow>“使用しない”を選ぶと、<br>　オートワードを設定していても<br>　発言しなくなります。<c>
Config_072_Name - オートワードをログに表示
Config_072_Hint - オートワードをログに表示するかを設定します。
Config_073_Name - ログウィンドウ表示順
Config_073_Choices_0_VITA - 最新を上から表示する
Config_073_Choices_1_VITA - 最新を下から表示する
Config_073_Hint_VITA - ログを表示する順序を設定します。
Config_074_Name - イベント
Config_074_Hint - 画面に表示する他者のオートワードカテゴリーを<br>設定します。
Config_075_Name - メンバー
Config_076_Name - アクション
Config_077_Name - 周囲
Config_077_Hint - ログウィンドウの「すべて表示」タブに<br>表示する内容を選択します。
Config_078_Name - パーティー
Config_079_Name - チーム
Config_080_Name - ウィスパー
Config_081_Name - システム
Config_082_Name - キャラクター
Config_083_Name - グループチャット
Config_084_Name - スクリーンショット保存形式
Config_084_Choices_0 - JPEG
Config_084_Choices_1 - PNG
Config_084_Choices_2 - BMP
Config_084_Hint - スクリーンショットを保存する際の<br>保存形式を選択します。
Config_085_Name - スクリーンショット撮影時のUI表示設定
Config_085_Choices_0 - すべて表示
Config_085_Choices_1 - フキダシのみ表示
Config_085_Choices_2 - 表示なし
Config_085_Hint - スクリーンショット撮影時に、<br>UI（ウィンドウなどのインターフェイス）を<br>表示するかを設定します。<br>※ゲーム内の撮影機能を利用時のみ有効。
Config_085_Choices_0_Switch - ウィンドウ表示あり
Config_085_Choices_1_Switch - ウィンドウ表示なし
Config_085_Hint_Switch - スクリーンショット撮影時に、<br>UI（ウィンドウなどのインターフェイス）を<br>表示するかを設定します。<br>※ゲーム内の撮影機能を利用時のみ有効。
Config_086_Name - エステでの体型変更の同期設定１
Config_086_Choices_0 - 自動的に切り替える
Config_086_Choices_1 - 個別に編集する
Config_086_Hint - エステで、コスチュームや<br>キャストのパーツなどを変更する時に、<br><yellow>ヒト型とキャスト型の体型<c>を<br>自動的に切り替えるか、<br>個別に編集するかを設定します。
Config_087_Name - 操作設定
Config_087_Choices_0 - マニュアルタイプ
Config_087_Choices_1 - オートタイプ
Config_087_Hint - ライドロイドの操作設定を選択します。 <br> <br>マニュアルタイプ： 手動で前進します。<br>オートタイプ： 自動で前進します。 <br><br>※ライドロイドの操作は<br>　　「<yellow>肩越し視点<c>」が基本です。
Config_088_Name - 通常視点：カメラ左右回転方向
Config_088_Hint - ライドロイドカメラの左右回転方向を設定します。
Config_089_Name - 通常視点：カメラ上下回転方向
Config_089_Hint - ライドロイドカメラの上下回転方向を設定します。
Config_090_Name - 通常視点：左右旋回方向
Config_090_Hint - ライドロイド操作の左右旋回方向を設定します。
Config_091_Name - 通常視点：上下移動方向
Config_091_Hint - ライドロイド操作の上下移動方向を設定します。
Config_092_Name - 肩越し視点：カメラ左右回転方向
Config_093_Name - 肩越し視点：カメラ上下回転方向
Config_094_Name - 肩越し視点：左右旋回方向
Config_095_Name - 肩越し視点：上下移動方向
Config_096_Name - ダークブラスト時の専用ボイス
Config_096_Hint - ダークブラストの発動中、<br>専用ボイスを再生するかどうか設定します。
Config_097_Name - 他者のダークブラスト表示タイプ
Config_097_Choices_0 - 他者の設定に従う
Config_097_Choices_1 - オーラ表示
Config_097_Choices_2 - キャラクター表示
Config_097_Hint - 他のプレイヤーがダークブラストを使用した時の<br>見た目を設定します。<br><br>【他者の設定に従う】<br>他のプレイヤーの設定に従って表示します。<br><br>【オーラ表示】<br>ダークブラストの見た目をオーラ表示にします。<br>透明度は他プレイヤーの設定が反映されます。<br><br>【キャラクター表示】<br>ダークブラストを表示せず<br>常にキャラクターを表示します。<br><br>ゲームランチャーの環境設定からシェーダー品質を<br>「簡易」以外に設定することで適用されます。
Config_097_Hint_PS4 - 他のプレイヤーがダークブラストを使用した時の<br>見た目を設定します。<br><br>【他者の設定に従う】<br>他のプレイヤーの設定に従って表示します。<br><br>【オーラ表示】<br>ダークブラストの見た目をオーラ表示にします。<br>透明度は他プレイヤーの設定が反映されます。<br><br>【キャラクター表示】<br>ダークブラストを表示せず<br>常にキャラクターを表示します。
Config_097_Hint_Switch - 他のプレイヤーがダークブラストを使用した時の<br>見た目を設定します。<br><br>【他者の設定に従う】<br>他のプレイヤーの設定に従って表示します。<br><br>【オーラ表示】<br>ダークブラストの見た目をオーラ表示にします。<br>透明度は他プレイヤーの設定が反映されます。<br><br>【キャラクター表示】<br>ダークブラストを表示せず<br>常にキャラクターを表示します。
Config_097_Hint_PCCloud - 他のプレイヤーがダークブラストを使用した時の<br>見た目を設定します。<br><br>【他者の設定に従う】<br>他のプレイヤーの設定に従って表示します。<br><br>【オーラ表示】<br>ダークブラストの見た目をオーラ表示にします。<br>透明度は他プレイヤーの設定が反映されます。<br><br>【キャラクター表示】<br>ダークブラストを表示せず<br>常にキャラクターを表示します。
Config_098_Hint - BGMの音量を設定します。
Config_099_Hint - SEの音量を設定します。
Config_100_Hint - ボイスの音量を設定します。
Config_101_Hint - アークス・ロビーに設置されている<br>巨大モニターなどで表示される動画の<br>音量を設定します。
Config_102_Name - サラウンド設定
Config_102_Choices_0 - ON
Config_102_Choices_1 - OFF
Config_102_Hint - サラウンド効果のON/OFFを切り替えます。
Config_103_Name - グローバルフォーカスサウンド設定
Config_103_Hint - ゲームがアクティブになっていない状態で、<br>サウンドを再生するかどうか設定します。
Config_104_Name - エフェクト光源
Config_104_Hint - エフェクトに関係するライティングの<br>ON/OFFを切り替えます。<br><br>OFFにすると処理がやや軽くなります。
Config_105_Name - 地形光源
Config_105_Hint - 地形に関係するライティングの<br>ON/OFFを切り替えます。<br><br>OFFにすると処理がやや軽くなります。
Config_105_Hint_PS4 - 地形に関係するライティングの<br>ON/OFFを切り替えます。<br><br>OFFにすると処理がやや軽くなります。
Config_105_Hint_Switch - 地形に関係するライティングの<br>ON/OFFを切り替えます。
Config_105_Hint_PCCloud - 地形に関係するライティングの<br>ON/OFFを切り替えます。
Config_106_Name - ブルーム処理
Config_106_Hint - 明るい部分にフィルターをかけ、<br>画面全体をよりきれいに見せる効果の<br>ON/OFFを切り替えます。<br><br>OFFにすると処理がやや軽くなります。
Config_106_Hint_PS4 - 明るい部分にフィルターをかけ、<br>画面全体をよりきれいに見せる効果の<br>ON/OFFを切り替えます。<br><br>OFFにすると処理がやや軽くなります。
Config_107_Name - 被写界深度
Config_107_Hint - 一部のイベントシーンなどで、<br>背景をぼかす効果のON/OFFを切り替えます。<br><br>OFFにすると処理がやや軽くなります。
Config_107_Hint_PS4 - 一部のイベントシーンなどで、<br>背景をぼかす効果のON/OFFを切り替えます。<br><br>OFFにすると処理がやや軽くなります。
Config_108_Name - ブラー
Config_108_Hint - カメラやキャラクターなどの動きに、<br>残像のような効果を付ける機能の<br>ON/OFFを切り替えます。<br><br>OFFにすると処理がやや軽くなります。
Config_109_Name - ライトシャフト
Config_109_Hint - 光が太陽を中心に拡散する表現の<br>ON/OFFを切り替えます。<br><br>OFFにすると処理が多少軽くなります。
Config_109_Hint_PS4 - 光が太陽を中心に拡散する表現の<br>ON/OFFを切り替えます。<br><br>OFFにすると処理が多少軽くなります。
Config_110_Name - アンチエイリアシング
Config_110_Hint - 曲線や斜めの線を滑らかに描写する機能の<br>ON/OFFを切り替えます。<br>設定によって処理負荷が異なり、<br>OFFにすると処理がやや軽くなります。<br><br><yellow>※TAAを含む設定にすると、<br>　『PSO2』の一部アイテムなどの<br>　見た目が変わる場合があります。<c>
Config_111_Name - ソフトパーティクル
Config_111_Hint - エフェクトの粒子（パーティクル）が<br>地面に近づいた際に薄くなる効果です。<br>一部エフェクトにのみ適用されます。<br><br>OFFにすると処理が多少軽くなります。
Config_111_Hint_PS4 - エフェクトの粒子（パーティクル）が<br>地面に近づいた際に薄くなる効果です。<br>一部エフェクトにのみ適用されます。<br><br>OFFにすると処理が多少軽くなります。
Config_112_Name - 一部のエフェクトの発光を軽減する
Config_112_Choices_0 - 通常
Config_112_Choices_1 - 軽減する
Config_112_Hint - 一部のエフェクトの光り方の強弱を切り替えます。<br>「軽減する」を選択すると、光り方が弱くなります。
Config_112_Hint_Switch - 一部のエフェクトの光り方の強弱を切り替えます。<br>「軽減する」を選択すると、光り方が弱くなります。
Config_112_Hint_PCCloud - 一部のエフェクトの光り方の強弱を切り替えます。<br>「軽減する」を選択すると、光り方が弱くなります。
Config_113_Name - 他者の一部エフェクトを透過する範囲
Config_113_Choices_0 - 近くのエフェクトのみ
Config_113_Choices_1 - 距離に関わらず透過
Config_113_Hint - 他プレイヤーからの一部のエフェクトを<br>透過する範囲を設定します。<br><br>「距離に関わらず透過」を選択すると<br>すべての範囲で一部エフェクトを透過します。
Config_114_Name - アンビエントオクルージョン
Config_114_Hint - 物体の外縁部にできる影を、<br>より精密に描写する機能の<br>ON/OFFを切り替えます。<br><br>OFFにすると処理がやや軽くなります。
Config_114_Hint_PS4 - 物体の外縁部にできる影を、<br>より精密に描写する機能の<br>ON/OFFを切り替えます。<br><br>OFFにすると処理がやや軽くなります。
Config_115_Name - 周辺減光
Config_115_Hint - 画面の外縁部を暗めにする機能の<br>ON/OFFを切り替えます。<br><br>OFFにすると処理がやや軽くなります。
Config_115_Hint_PS4 - 画面の外縁部を暗めにする機能の<br>ON/OFFを切り替えます。<br><br>OFFにすると処理がやや軽くなります。
Config_116_Name - 色調トーンカーブ
Config_116_Hint - 画面全体の色調やコントラスト、明るさを<br>フィールドごとに調整する機能の<br>ON/OFFを切り替えます。<br><br>OFFにすると処理がやや軽くなります。
Config_116_Hint_PS4 - 画面全体の色調やコントラスト、明るさを<br>フィールドごとに調整する機能の<br>ON/OFFを切り替えます。<br><br>OFFにすると処理がやや軽くなります。
Config_116_Hint_Switch - 画面全体の色調やコントラスト、明るさを<br>フィールドごとに調整する機能の<br>ON/OFFを切り替えます。<br><br>OFFにすると処理がやや軽くなります。
Config_116_Hint_PCCloud - 画面全体の色調やコントラスト、明るさを<br>フィールドごとに調整する機能の<br>ON/OFFを切り替えます。<br><br>OFFにすると処理がやや軽くなります。
Config_117_Name - エッジライト
Config_117_Hint - オブジェクトの周囲にかかる光量を調整します。<br><br>OFFにすると処理が多少軽くなります。<br><br>ゲームランチャーの環境設定からシェーダー品質を<br>「高品質」に設定することで使用できるようになります。
Config_117_Hint_PS4 - オブジェクトの周囲にかかる光量を調整します。<br><br>OFFにすると処理が多少軽くなります。
Config_117_Hint_Switch - オブジェクトの周囲にかかる光量を調整します。
Config_117_Hint_PCCloud - オブジェクトの周囲にかかる光量を調整します。
Config_118_Name - 解像度の自動縮小機能
Config_118_Hint_PS4 - 負荷が高い時に解像度を下げて、<br>フレームレートを維持する機能の<br>ON/OFFを切り替えます。<br><br>OFFにすると戦闘中などの時に、<br>フレームレートが低くなる場合があります。
Config_119_Hint - 武器などを詳細に描写する<br>キャラクターの最大数を設定します。<br><br>数値を下げると処理がやや軽くなります。
Config_120_Hint - フォトンブラストの表示数を設定します。<br><br>数値を下げると処理が多少軽くなります。
Config_121_Hint - 水面への映り込みのクオリティを設定します。<br><br>数値を下げると処理が多少軽くなります。
Config_122_Hint - 物体に落ちる影を、<br>どの程度精密に描写するかを設定します。<br><br>数値を下げると処理がやや軽くなります。
Config_124_Hint_PS4 - 画面の明るさを設定します。<br>数値を下げると画面全体の明るさを<br>おさえることができます。
Config_123_Hint - カメラが向いている方向の光量を調節して<br>画面の明るさを設定します。<br><br>数値を0にすると処理が多少軽くなります。
Config_125_Hint - マウス操作時のカメラ回転速度を補正します。<br>数値を下げることでマウス操作時の<br>カメラ回転速度がゆっくりになります。
Config_127_Name - 他者のアクセサリー非表示機能
Config_127_Choices_0 - 使用しない
Config_127_Choices_1 - PSO2ブロックリスト対象者
Config_127_Choices_2 - すべてのキャラクター
Config_127_Hint - 他者のアクセサリーを表示するかを設定します。<br>「PSO2ブロックリスト対象者」「すべてのキャラクター」<br>を選択すると、対象となるプレイヤーキャラクターの<br>アクセサリーが非表示になります。
Config_128_Name - ボイスチャット機能
Config_128_Choices_0 - 使用する
Config_128_Choices_1 - 使用しない
Config_128_Hint - ボイスチャットを利用するかを設定します。<br>利用しない場合は自分の声や他プレイヤーの<br>ボイスが届かない状態になります。
Config_129_Name - ウィッシュリスト、プレゼントリスト項目
Config_129_Choices_0 - 表示しない
Config_129_Choices_1 - 表示する
Config_129_Hint - アイテムメニューに<br>「ウィッシュリストに追加」<br>「プレゼントリストに追加」の項目を<br>表示するかを設定します。
Config_130_Name - 素材倉庫への自動送り
Config_130_Choices_0 - 使用する
Config_130_Choices_1 - 使用しない
Config_130_Hint - 『オーダーアイテム／素材』カテゴリーの<br>アイテムを取得した際、素材倉庫が有効な場合に<br>自動で素材倉庫へ送るかを設定します。<br><br>【対象となる取得方法】<br>・ドロップアイテム<br>・ギャザリング<br>・Eトライアル報酬<br>・クエストのリザルト報酬
Config_Reb_001_Name - レーダーマップの回転
Config_Reb_001_Hint - レーダーマップを、カメラの向きに合わせて<br>回転させるかを設定します。
Config_Reb_001_Select_0 - 回転しない
Config_Reb_001_Select_1 - 回転する
Config_Reb_002_Name - 攻撃属性によるHPバーのカラー
Config_Reb_002_Hint - ダメージを受けた際に表示されるHPバーの色を<br>攻撃属性（打撃、射撃、法撃）に依存した色で<br>表示するかしないか設定します。
Config_Reb_002_Select_0 - 攻撃属性に依存しない
Config_Reb_002_Select_1 - 攻撃属性に依存する
Config_Reb_003_Name - サブパレットのアイコン名称表示
Config_Reb_003_Hint - サブパレットの選択時に、<br>アイコンの名称を表示するかを設定します。
Config_Reb_003_Select_0 - 表示しない
Config_Reb_003_Select_1 - 切り替え時のみ表示する
Config_Reb_003_Select_2 - 常に表示する
Config_Reb_004_Name - レアアイテムのドロップ演出表示
Config_Reb_004_Hint - レアアイテムのドロップ演出を<br>表示するかを設定します。
Config_Reb_004_Select_0 - 表示しない
Config_Reb_004_Select_1 - SEのみ再生する
Config_Reb_004_Select_2 - 表示する
Config_Reb_005_Name - ボリュームフォグ
Config_Reb_005_Hint - 光が霧やちりに反射する表現の<br>ON/OFFを切り替えます。<br><br>OFFにすると処理がやや軽くなります。
Config_Reb_006_Name - キャラクターメニューの表示形式
Config_Reb_006_Hint - 周囲のキャラクターを選択した時などに表示される<br>キャラクターメニューの形式を設定します。
Config_Reb_006_Select_0 - カテゴリー
Config_Reb_006_Select_1 - 一覧
Config_Reb_007_Name - 復帰プレイヤーアイコン表示
Config_Reb_007_Hint - 復帰プレイヤーアイコンを<br>表示するかしないかを設定します。<br>※アイコンを表示しなくても<br>　各ボーナスは受けられます。
Config_Reb_007_Select_0 - 表示しない
Config_Reb_007_Select_1 - 表示する
Config_Reb_008_Name - ゲーム内モニターの動画再生
Config_Reb_008_Hint - シティなどに設置されたモニターで<br>動画を再生するかを設定します。
Config_Reb_008_Select_0 - 再生しない
Config_Reb_008_Select_1 - 再生する
Config_Reb_009_Name - パーティー設定の保存
Config_Reb_009_Hint - パーティー設定を一時的に保存し、<br>ブロック移動やログアウトを行っても<br>設定を維持するかを設定します。<br><br><yellow>※保存されたパーティー設定は<br>　ゲームを終了するまで有効です。<c><br><br><yellow>※“保存しない”を選択した場合でも、<br>　パスワードの設定はログアウトするまで有効です。<c>
Config_Reb_009_Select_0 - 保存しない
Config_Reb_009_Select_1 - 保存する
Config_Reb_010_Name - イベント注目機能
Config_Reb_010_Hint - イベント発生時にアクセスボタンをホールドして<br>イベント注目をする機能を使用するか設定します。
Config_Reb_010_Select_0 - 使用しない
Config_Reb_010_Select_1 - 使用する
Config_Reb_011_Name - 他パーティーのキャラクター名表示色
Config_Reb_011_Hint - 他パーティーのキャラクター名を、<br>何色で表示するかを設定します。
Config_Reb_011_Select_0 - 白
Config_Reb_011_Select_1 - 青
Config_Reb_012_Name - クエスト受注時のパーティー名
Config_Reb_012_Hint - パーティー名を入力せずにクエストを受注した時に<br>自動的につけられるパーティー名を選択します。 <br><br>【クエスト名】<br>受注したクエスト名を表示します。<br><br>【キャラクター名】<br>受注したキャラクター名を表示します。
Config_Reb_012_Select_0 - クエスト名
Config_Reb_012_Select_1 - キャラクター名
Config_Reb_013_Name - ビギナーブロック優先ログイン設定
Config_Reb_013_Hint - レベル20以下のキャラクターでログインする時、<br>優先的にビギナーブロックへ入るか選択します。
Config_Reb_013_Select_0 - 優先しない
Config_Reb_013_Select_1 - 優先する
Config_Reb_014_Name - 倉庫の初期カーソル位置設定
Config_Reb_014_Hint - 倉庫端末やマイショップ出品時<br>NPCショップでのアイテム売買において<br>倉庫UIが表示された時の<br>初期カーソル位置を設定します。
Config_Reb_014_Select_0 - すべての倉庫
Config_Reb_014_Select_1 - 基本倉庫
Config_Reb_014_Select_2 - キャラ倉庫
Config_Reb_014_Select_3 - プレミアム倉庫
Config_Reb_014_Select_4 - ＯＴＰ倉庫
Config_Reb_014_Select_5 - PSO2es倉庫
Config_Reb_015_Name - クエスト受注時の初期カーソル位置
Config_Reb_015_Hint - 複数ブロックマッチング可能なクエストの受注時<br>カーソル位置をどちらのボタンにするか設定します。<br><br>※一部クエストを除きます。
Config_Reb_015_Select_0 - 複数のブロックを検索
Config_Reb_015_Select_1 - 現在のブロックで受注
Config_Reb_016_Name - パーティーの招待通知
Config_Reb_016_Hint - パーティーに招待された時に、<br>新着通知のウィンドウを表示するかを設定します。
Config_Reb_016_Select_0 - 表示しない
Config_Reb_016_Select_1 - 表示する
Config_Reb_017_Name - フレンド登録の通知
Config_Reb_017_Hint - フレンド登録を申し込まれた時に、<br>新着通知のウィンドウを表示するかを設定します。
Config_Reb_017_Select_0 - 表示しない
Config_Reb_017_Select_1 - 表示する
Config_Reb_018_Name - チームスカウトの通知
Config_Reb_018_Hint - チームにスカウトされた時に、<br>新着通知のウィンドウを表示するかを設定します。
Config_Reb_018_Select_0 - 表示しない
Config_Reb_018_Select_1 - 表示する
Config_Reb_019_Name - トレード申し込み通知
Config_Reb_019_Hint - トレードを提案された時、<br>返答選択ウィンドウを表示するかを設定します。
Config_Reb_019_Select_0 - 表示しない
Config_Reb_019_Select_1 - 表示する
Config_Reb_020_Name - アイテム取得時のログ表示
Config_Reb_020_Hint - アイテムを取得した時に、<br>ログに表示するかを設定します。
Config_Reb_020_Select_0 - 表示しない
Config_Reb_020_Select_1 - 表示する
Config_Reb_021_Name - プレミアムセットの有効期限切れ通知
Config_Reb_021_Hint - プレミアムセットの<br>有効期限が切れる７日より前に、<br>ログイン時にその旨を通知するかを設定します。
Config_Reb_021_Select_0 - 表示しない
Config_Reb_021_Select_1 - 表示する
Config_Reb_022_Name - おすすめオーダーの通知
Config_Reb_022_Hint - おすすめクエストを受注した時<br>おすすめオーダーの受注メニューを<br>表示するかを設定します。
Config_Reb_022_Select_0 - 表示しない
Config_Reb_022_Select_1 - 表示する
Config_Reb_023_Name - パーティー内のレアアイテム取得通知
Config_Reb_023_Hint - パーティーメンバーが<br>レアアイテムを取得した時に、<br>通知をするかを設定します。
Config_Reb_023_Select_0 - 表示しない
Config_Reb_023_Select_1 - 表示する
Config_Reb_024_Name - 複数ブロックマッチングのクエスト受注確認表示
Config_Reb_024_Hint - パーティーリーダーが複数ブロックマッチングで<br>クエストを受注した時、受注確認のウィンドウを<br>自動で開くかを設定します。
Config_Reb_024_Select_0 - 表示しない
Config_Reb_024_Select_1 - 表示する
Config_Reb_025_Name - ログインコールの送信
Config_Reb_025_Hint - 自分がログインした時に、<br>フレンドにログインコールを送るかを設定します。
Config_Reb_025_Select_0 - 送らない
Config_Reb_025_Select_1 - 送る
Config_Reb_026_Name - 他プレイヤーの戦闘不能通知
Config_Reb_026_Hint - パーティーメンバーを含め、<br>他プレイヤーの戦闘不能通知を<br>表示するかを設定します。
Config_Reb_026_Select_0 - 表示しない
Config_Reb_026_Select_1 - 表示する
Config_Reb_027_Name - 自分の戦闘不能通知
Config_Reb_027_Hint - 自分が戦闘不能になった時に、<br>周囲のプレイヤーに戦闘不能アイコンを<br>表示するかを設定します。<br><br><yellow>※相手側の表示設定がOFFの場合、<br>　相手に戦闘不能アイコンは表示されません。<c>
Config_Reb_027_Select_0 - 表示しない
Config_Reb_027_Select_1 - 表示する
Config_Reb_028_Name - エステでの体型変更の同期設定１
Config_Reb_028_Hint - エステで、コスチュームや<br>キャストのパーツなどを変更する時に、<br><yellow>ヒト型とキャスト型の体型<c>を<br>自動的に切り替えるか、<br>個別に編集するかを設定します。
Config_Reb_028_Select_0 - 自動的に切り替える
Config_Reb_028_Select_1 - 個別に編集する
Config_Reb_029_Name - ロックオンの切り替え
Config_Reb_029_Hint - ロックオン操作で、<br>ボタンやキーを押すたびに<br>ロックオンのON/OFFを切り替えるか、<br>押している間のみロックオンするかを選択します。
Config_Reb_029_Select_0 - ワンプッシュ
Config_Reb_029_Select_1 - ホールド
Config_Reb_030_Name - <%RStick>によるロックオン対象の切り替え
Config_Reb_030_Hint - ロックオン中に、<br><%RStick>で対象を切り替える機能を<br>使用するかを設定します。
Config_Reb_030_Select_0 - 使用しない
Config_Reb_030_Select_1 - 使用する
Config_Reb_031_Name - 裏パレットの切り替え
Config_Reb_031_Hint - 裏パレットの切り替え操作で、<br>ボタンやキーを押すたびに切り替えるか、<br>押している間のみ切り替えるかを選択します。
Config_Reb_031_Select_0 - ワンプッシュ
Config_Reb_031_Select_1 - ホールド
Config_Reb_032_Name - 回避操作の移動キー２回押し間隔
Config_Reb_032_Hint - キーボードのキャラクター移動キー<br>（初期設定で[W]/[A]/[S]/[D]キー）を<br>２回押しして、“回避アクション”をする時の<br>入力受け付け間隔を設定します。
Config_Reb_032_Select_0 - 長間隔
Config_Reb_032_Select_1 - 中間隔
Config_Reb_032_Select_2 - 短間隔
Config_Reb_032_Select_3 - ２回押し無効
Config_Reb_033_Name - 通常視点：カメラの左右回転方向
Config_Reb_033_Hint - カメラの左右回転方向を設定します。<br><br><yellow>※通常視点にのみ適用されます。<c>
Config_Reb_033_Select_0 - 標準
Config_Reb_033_Select_1 - 反転
Config_Reb_034_Name - 通常視点：カメラの上下回転方向
Config_Reb_034_Hint - カメラの上下回転方向を設定します。<br><br><yellow>※通常視点にのみ適用されます。<c>
Config_Reb_034_Select_0 - 標準
Config_Reb_034_Select_1 - 反転
Config_Reb_035_Name - 通常視点：カメラの左右回転速度
Config_Reb_035_Hint - カメラの左右回転の速さを設定します。<br>数値を下げることで回転速度が遅くなります。<br><br><yellow>※通常視点にのみ適用されます。<c>
Config_Reb_036_Name - 通常視点：カメラの上下回転速度
Config_Reb_036_Hint - カメラの上下回転の速さを設定します。<br>数値を下げることで回転速度が遅くなります。<br><br><yellow>※通常視点にのみ適用されます。<c>
Config_Reb_037_Name - 通常視点：マウスの優先操作
Config_Reb_037_Hint - マウスで操作する時に、<br>カメラの操作を優先するか、<br>マウスカーソルの操作を優先するかを設定します。<br><br><yellow>※通常視点にのみ適用されます。<c>
Config_Reb_037_Select_0 - カメラ
Config_Reb_037_Select_1 - マウスカーソル
Config_Reb_038_Name - 肩越し視点：カメラの左右回転方向
Config_Reb_038_Hint - カメラの左右回転方向を設定します。<br><br><yellow>※肩越し視点にのみ適用されます。<c>
Config_Reb_038_Select_0 - 標準
Config_Reb_038_Select_1 - 反転
Config_Reb_039_Name - 肩越し視点：カメラの上下回転方向
Config_Reb_039_Hint - カメラの上下回転方向を設定します。<br><br><yellow>※肩越し視点にのみ適用されます。<c>
Config_Reb_039_Select_0 - 標準
Config_Reb_039_Select_1 - 反転
Config_Reb_040_Name - 肩越し視点：カメラの左右回転速度
Config_Reb_040_Hint - カメラの左右回転の速さを設定します。<br>数値を下げることで回転速度が遅くなります。<br><br><yellow>※肩越し視点にのみ適用されます。<c>
Config_Reb_041_Name - 肩越し視点：カメラの上下回転速度
Config_Reb_041_Hint - カメラの上下回転の速さを設定します。<br>数値を下げることで回転速度が遅くなります。<br><br><yellow>※肩越し視点にのみ適用されます。<c>
Config_Reb_042_Name - 肩越し視点：マウスの優先操作
Config_Reb_042_Hint - マウスで操作する時に、<br>カメラの操作を優先するか、<br>マウスカーソルの操作を優先するかを設定します。<br><br><yellow>※肩越し視点にのみ適用されます。<c>
Config_Reb_042_Select_0 - カメラ
Config_Reb_042_Select_1 - マウスカーソル
Config_Reb_047_Name - ダイレクトチャットの使用
Config_Reb_047_Hint - キーボードをチャットなどの文字入力のみに<br>使用するかを設定します。<br><br><yellow>※“使用する”を選ぶと、キャラクターの<br>　移動などのアクション機能が無効化されます。<c>
Config_Reb_047_Select_0 - 使用しない
Config_Reb_047_Select_1 - 使用する
Config_Reb_048_Name - オートワードの使用
Config_Reb_048_Hint - オートワードを使用するかを設定します。<br><br><yellow>“使用しない”を選ぶと、<br>　オートワードを設定していても<br>　発言しなくなります。<c>
Config_Reb_048_Select_0 - 使用しない
Config_Reb_048_Select_1 - 使用する
Config_Reb_049_Name - 他プレイヤーのオートワード表示：イベント
Config_Reb_049_Hint - 他プレイヤーのオートワード“イベント”を、<br>表示するかを設定します。
Config_Reb_049_Select_0 - 表示しない
Config_Reb_049_Select_1 - 表示する
Config_Reb_091_Name - 他プレイヤーのオートワード表示：メンバー
Config_Reb_091_Hint - 他プレイヤーのオートワード“メンバー”を、<br>表示するかを設定します。
Config_Reb_091_Select_0 - 表示しない
Config_Reb_091_Select_1 - 表示する
Config_Reb_092_Name - 他プレイヤーのオートワード表示：アクション
Config_Reb_092_Hint - 他プレイヤーのオートワード“アクション”を、<br>表示するかを設定します。
Config_Reb_092_Select_0 - 表示しない
Config_Reb_092_Select_1 - 表示する
Config_Reb_050_Name - オートワードのログ表示
Config_Reb_050_Hint - オートワードをログに表示するかを設定します。
Config_Reb_050_Select_0 - 表示しない
Config_Reb_050_Select_1 - 表示する
Config_Reb_051_Name - メール返信時の相手文章引用
Config_Reb_051_Hint - メール返信時に、<br>相手の文章を引用するかを設定します。
Config_Reb_051_Select_0 - 引用しない
Config_Reb_051_Select_1 - 引用する
Config_Reb_053_Name - チームチャットのフキダシ表示
Config_Reb_053_Hint - チームチャットのフキダシを<br>表示するかを設定します。
Config_Reb_053_Select_0 - すべて表示する
Config_Reb_053_Select_1 - 同エリア内でのみ表示する
Config_Reb_053_Select_2 - 表示しない
Config_Reb_054_Name - シンボルアートの表示
Config_Reb_054_Hint - シンボルアートを表示するかを設定します。<br><br><yellow>※“表示しない”を選ぶと、<br>　自分のシンボルアートも<br>　他プレイヤーのシンボルアートも<br>　表示されなくなります。<c>
Config_Reb_054_Select_0 - 表示しない
Config_Reb_054_Select_1 - 表示する
Config_Reb_055_Name - チャットの発言者名表示
Config_Reb_055_Hint - チームチャット、ウィスパーチャット、<br>グループチャットの発言者名表示を設定します。
Config_Reb_055_Select_0 - プレイヤーIDネーム
Config_Reb_055_Select_1 - キャラクター名
Config_Reb_056_Name - チャット入力欄の背景色
Config_Reb_056_Hint - チャット入力欄の背景色を、<br>パーティーチャット、チームチャットなどの<br>項目ごとに変更するかを設定します。
Config_Reb_056_Select_0 - 色を変えない
Config_Reb_056_Select_1 - 色を変える
Config_Reb_057_Name - BGM音量
Config_Reb_057_Hint - BGMの音量を設定します。
Config_Reb_058_Name - SE音量
Config_Reb_058_Hint - SEの音量を設定します。
Config_Reb_059_Name - ボイス音量
Config_Reb_059_Hint - ボイスの音量を設定します。
Config_Reb_060_Name - ゲーム内動画音量
Config_Reb_060_Hint - ゲーム内再生動画の音量を設定します。
Config_Reb_061_Name - サラウンド
Config_Reb_061_Hint - サラウンド効果のON/OFFを切り替えます。
Config_Reb_061_Select_0 - OFF
Config_Reb_061_Select_1 - ON
Config_Reb_062_Name - グローバルフォーカスサウンド
Config_Reb_062_Hint - ゲーム画面がアクティブになっていない時に、<br>サウンドを再生するかを設定します。
Config_Reb_062_Select_0 - OFF
Config_Reb_062_Select_1 - ON
Config_Reb_063_Name - スクリーンショットの保存形式
Config_Reb_063_Hint - スクリーンショットの保存形式を設定します。
Config_Reb_063_Select_0 - JPEG
Config_Reb_063_Select_1 - PNG
Config_Reb_063_Select_2 - BMP
Config_Reb_064_Name - スクリーンショット撮影時のUI表示設定
Config_Reb_064_Hint - スクリーンショットを保存する時に、<br>UI（ウィンドウなどのインターフェイス）を<br>表示するかを設定します。<br><br><yellow>※ゲーム内の撮影機能にのみ適用されます。<c>
Config_Reb_064_Select_0 - すべて表示する
Config_Reb_064_Select_1 - フキダシのみ表示する
Config_Reb_064_Select_2 - 表示しない
Config_Reb_065_Name - エフェクト光源
Config_Reb_065_Hint - エフェクトに関係するライティングの<br>ON/OFFを切り替えます。<br><br>OFFにすると処理がやや軽くなります。
Config_Reb_065_Select_0 - OFF
Config_Reb_065_Select_1 - ON
Config_Reb_066_Name - 地形光源
Config_Reb_066_Hint - 地形に関係するライティングの<br>ON/OFFを切り替えます。<br><br>OFFにすると処理がやや軽くなります。
Config_Reb_066_Select_0 - OFF
Config_Reb_066_Select_1 - ON
Config_Reb_067_Name - ブルーム処理
Config_Reb_067_Hint - 明るい部分にフィルターをかけ、<br>画面全体をよりきれいに見せる効果の<br>ON/OFFを切り替えます。<br><br>OFFにすると処理がやや軽くなります。
Config_Reb_067_Select_0 - OFF
Config_Reb_067_Select_1 - ON
Config_Reb_068_Name - 被写界深度
Config_Reb_068_Hint - 一部のイベントシーンなどで、<br>背景をぼかす効果のON/OFFを切り替えます。<br><br>OFFにすると処理がやや軽くなります。
Config_Reb_068_Select_0 - OFF
Config_Reb_068_Select_1 - ON
Config_Reb_069_Name - ブラー
Config_Reb_069_Hint - カメラやキャラクターなどの動きに、<br>残像のような効果を付ける機能の<br>ON/OFFを切り替えます。<br><br>OFFにすると処理がやや軽くなります。
Config_Reb_069_Select_0 - OFF
Config_Reb_069_Select_1 - ON
Config_Reb_070_Name - ライトシャフト
Config_Reb_070_Hint - 光が太陽を中心に拡散する表現の<br>ON/OFFを切り替えます。<br><br>OFFにすると処理がやや軽くなります。
Config_Reb_070_Select_0 - OFF
Config_Reb_070_Select_1 - ON
Config_Reb_071_Name - アンチエイリアシング
Config_Reb_071_Hint - 曲線や斜めの線を滑らかに描写する機能の<br>ON/OFFを切り替えます。<br>設定によって処理負荷が異なり、<br>OFFにすると処理がやや軽くなります。<br><br><yellow>※TAAを含む設定にすると、<br>　『PSO2』の一部アイテムなどの<br>　見た目が変わる場合があります。<c>
Config_Reb_071_Select_0 - OFF
Config_Reb_071_Select_1 - FXAA
Config_Reb_071_Select_2 - TAA
Config_Reb_071_Select_3 - TAA + FXAA
Config_Reb_072_Name - -
Config_Reb_072_Hint - -
Config_Reb_072_Select_0 - -
Config_Reb_072_Select_1 - -
Config_Reb_073_Name - -
Config_Reb_073_Hint - -
Config_Reb_073_Select_0 - -
Config_Reb_073_Select_1 - -
Config_Reb_074_Name - アンビエントオクルージョン
Config_Reb_074_Hint - 物体の外縁部にできる影を、<br>より精密に描写する機能の<br>ON/OFFを切り替えます。<br><br>OFFにすると処理がやや軽くなります。
Config_Reb_074_Select_0 - OFF
Config_Reb_074_Select_1 - ON
Config_Reb_075_Name - 周辺減光
Config_Reb_075_Hint - 画面の外縁部を暗めにする機能の<br>ON/OFFを切り替えます。<br><br>OFFにすると処理がやや軽くなります。
Config_Reb_075_Select_0 - OFF
Config_Reb_075_Select_1 - ON
Config_Reb_076_Name - 色調トーンカーブ
Config_Reb_076_Hint - 画面全体の色調やコントラスト、明るさを<br>フィールドごとに調整する機能の<br>ON/OFFを切り替えます。<br><br>OFFにすると処理がやや軽くなります。
Config_Reb_076_Select_0 - OFF
Config_Reb_076_Select_1 - ON
Config_Reb_077_Name - -
Config_Reb_077_Hint - -
Config_Reb_077_Select_0 - -
Config_Reb_077_Select_1 - -
Config_Reb_078_Name - 解像度の自動縮小機能
Config_Reb_078_Hint - 負荷が高い時に解像度を下げて、<br>フレームレートを維持する機能の<br>ON/OFFを切り替えます。<br><br>OFFにすると戦闘中などの時に、<br>フレームレートが低くなる場合があります。
Config_Reb_078_Select_0 - OFF
Config_Reb_078_Select_1 - ON
Config_Reb_079_Name - 詳細に描写するキャラクター表示数
Config_Reb_079_Hint - 武器などを詳細に描写する<br>キャラクターの最大数を設定します。<br><br>数値を下げると処理がやや軽くなります。
Config_Reb_080_Name - 他プレイヤーのエフェクト不透明度
Config_Reb_080_Hint - 他プレイヤーの周囲に発生するエフェクトを、<br>どの程度はっきりと表示するかを設定します。<br><br>数値を下げるとエフェクトが薄くなります。
Config_Reb_081_Name - 影品質
Config_Reb_081_Hint - 物体に落ちる影を、<br>どの程度精密に描写するかを設定します。<br><br>数値を下げると処理がやや軽くなります。
Config_Reb_082_Name - カメラライト
Config_Reb_082_Hint - カメラが向いている方向の光量を調整して、<br>キャラクターなどの明るさを設定します。<br><br>数値を0にすると処理がやや軽くなります。
Config_Reb_083_Name_old - エネミーガイドの表示
Config_Reb_083_Hint_old - レーダーマップのエネミーガイドの表示を設定します。
Config_Reb_083_Select_0 - 表示しない
Config_Reb_083_Select_1 - 切り替え時のみ表示する
Config_Reb_084_Name - 戦闘用ガイドアイコンの表示
Config_Reb_084_Hint - Ｔマーカー（トライアルマーカー）、<br>Ｅマーカー（エネミーマーカー）などの<br>ガイドアイコンを表示するかを設定します。
Config_Reb_084_Select_0 - 表示する
Config_Reb_084_Select_1 - 一時表示
Config_Reb_084_Select_2 - 表示しない
Config_Reb_085_Name - ウォールキックの実行
Config_Reb_085_Hint - ウォールキックを自動的に行うか、<br>手動で行うかを設定します。
Config_Reb_085_Select_0 - 自動
Config_Reb_085_Select_1 - 手動
Config_Reb_083_Name - 画面の振動
Config_Reb_083_Hint - エネミーの攻撃などによるカメラの振動を、<br>画面に反映するかを設定します。<br><br><yellow>※イベントシーンの演出には適用されません。<c>
Config_Reb_086_Name - 大型エネミーカメラ
Config_Reb_086_Hint - 大型エネミーとの戦闘中に、<br>カメラを広角にするかを設定します。
Config_Reb_086_Select_0 - OFF
Config_Reb_086_Select_1 - ON
Config_Reb_088_Name - ジャストアタックリング表示
Config_Reb_088_Hint - ジャストアタックの表示の濃さを設定します。
Config_Reb_088_Select_0 - 普通
Config_Reb_088_Select_1 - 薄い
Config_Reb_088_Select_2 - 非表示
Config_Reb_089_Name - ロックオンの優先対象
Config_Reb_089_Hint - ロックオンする対象を決める時に、<br>カメラの向いている側を優先するか、<br>キャラクターの向いている側を優先するかを<br>設定します。
Config_Reb_089_Select_0 - カメラの方向
Config_Reb_089_Select_1 - キャラクターの方向
Config_Reb_090_Name - スタンプの効果音再生
Config_Reb_090_Hint - スタンプの効果音や音声を<br>再生するかを設定します。<br><br><yellow>※“再生しない”を選ぶと、<br>　自分のスタンプも他プレイヤーのスタンプも<br>　効果音や音声が再生されなくなります。<c>
Config_Reb_090_Select_0 - 再生する
Config_Reb_090_Select_1 - 自分の近くでは再生しない
Config_Reb_090_Select_2 - 再生しない
Config_Reb_108_Name - スクリーンスペースリフレクション
Config_Reb_108_Hint - 一部地形への映り込みを、<br>より精密に描写する機能の<br>ON/OFFを切り替えます。<br><br>OFFにすると処理がやや軽くなります。
Config_Reb_106_Name - スクリーンスペースシャドウ
Config_Reb_106_Hint - 物体に落ちる一部の影を、<br>より精密に描写する機能の<br>ON/OFFを切り替えます。<br><br>OFFにすると処理がやや軽くなります。
Config_Reb_093_Name - 雲品質
Config_Reb_093_Hint - 雲を、<br>どの程度精密に描写するかを設定します。<br><br>数値を下げると処理がやや軽くなります。
Config_Reb_093_Select_0 - 低
Config_Reb_093_Select_1 - 中
Config_Reb_093_Select_2 - 高
Config_Reb_094_Name - パーティクル品質
Config_Reb_094_Hint - エフェクトのパーティクル（粒子）を、<br>どの程度精密に描写するかを設定します。<br><br>数値を下げると処理がやや軽くなります。
Config_Reb_095_Name - ファー表現
Config_Reb_095_Hint - 一部コスチュームやキャラクターの<br>毛皮や毛髪などを、より精密に描写する機能の<br>ON/OFFを切り替えます。<br><br>OFFにすると処理がやや軽くなります。
Config_Reb_096_Name - アンチスペキュラエイリアシング
Config_Reb_096_Hint - 光沢表現のノイズを抑えて、<br>より鮮明に描写する機能の<br>ON/OFFを切り替えます。<br><br>OFFにすると処理がやや軽くなります。
Config_Reb_097_Name - グローバルイルミネーション
Config_Reb_097_Hint - 自然な照明効果によって、<br>画面全体をよりきれいに見せる効果の<br>ON/OFFを切り替えます。<br><br>OFFにすると処理がやや軽くなります。<br><br><yellow>※再ログイン後に変更が適用されます。<c>
Config_Reb_098_Name - テッセレーション
Config_Reb_098_Hint - 一部地形の起伏などを、<br>より精密に描写する機能の<br>ON/OFFを切り替えます。<br><br>OFFにすると処理がやや軽くなります。
Config_Reb_099_Name - V-Sync
Config_Reb_099_Hint - 画面描画のズレを抑える機能です。<br><br>フレームレートがディスプレイの<br>リフレッシュレートよりも低い場合は<br>自動的に無効になります。
Config_Reb_100_Name - テクスチャフィルタリング
Config_Reb_100_Hint - テクスチャの滑らかさを設定します。<br><br>設定によって処理負荷が異なり、<br>“バイリニア”にすると処理がやや軽くなります。<br><br><yellow>※再ログイン後に変更が適用されます。<c>
Config_Reb_100_Select_0 - バイリニア
Config_Reb_100_Select_1 - トライリニア
Config_Reb_100_Select_2 - 異方性×4
Config_Reb_100_Select_3 - 異方性×8
Config_Reb_100_Select_4 - 異方性×16
Config_Reb_101_Name - テクスチャ解像度
Config_Reb_101_Hint - テクスチャの解像度を設定します。<br><br>設定を“低”にすると処理がやや軽くなります。<br><br><yellow>※再ログイン後に変更が適用されます。<c>
Config_Reb_101_Select_0 - 低
Config_Reb_101_Select_1 - 中
Config_Reb_101_Select_2 - 高
Config_Reb_101_Select_3 - 最高
Config_Reb_102_Name - 最大フレームレート
Config_Reb_102_Hint - 最大フレームレートを設定します。
Config_Reb_102_Select_0 - 無制限
Config_Reb_102_Select_1 - 30fps
Config_Reb_102_Select_2 - 60fps
Config_Reb_102_Select_3 - 90fps
Config_Reb_102_Select_4 - 120fps
Config_Reb_102_Select_5 - 144fps
Config_Reb_102_Select_6 - 165fps
Config_Reb_103_Name - 地形等の表示距離
Config_Reb_103_Hint - 詳細な地形や、<br>エネミーなどの表示距離を設定します。<br><br>数値を下げると処理がやや軽くなります。<br><br><yellow>※再ログイン後に変更が適用されます。<c>
Config_Reb_104_Name - 非アクティブ時のフレームレート制限
Config_Reb_104_Hint - ゲーム画面がアクティブになっていない時に、<br>フレームレートを下げて処理を軽くする機能の<br>ON/OFFを切り替えます。
Config_Reb_104_Choices_0 - 無効
Config_Reb_104_Choices_1 - 有効
Config_Reb_105_Name - 画面の明るさ
Config_Reb_105_Hint - 画面の明るさを設定します。<br>数値を下げると画面全体の明るさを<br>おさえることができます。
Config_Reb_107_Name - 周囲に装備を見せる
Config_Reb_107_Hint - 周囲に装備が見えるようにするか設定します。
Config_Reb_107_Select_0 - 見えない
Config_Reb_107_Select_1 - 見える
Config_Reb_109_Name - 簡易グラフィック設定
Config_Reb_109_Hint - グラフィック設定を一括設定します。
Config_Reb_109_Select_0 - 変更する
Config_Reb_043_Name - -
Config_Reb_043_Select_0 - -
Config_Reb_043_Select_1 - -
Config_Reb_043_Hint - -
Config_Reb_110_Name - 対象キャラクターのアクセサリー非表示
Config_Reb_110_Select_0 - 使用しない
Config_Reb_110_Select_1 - 『PSO2』ブロックリスト対象者
Config_Reb_110_Select_2 - すべてのキャラクター
Config_Reb_110_Hint - 他キャラクターのアクセサリーを、<br><yellow>非表示<c>にするかを設定します。
Config_Reb_111_Name - フォトンブラスト表示数
Config_Reb_111_Hint - フォトンブラストの表示数を設定します。<br>数値を下げると処理が多少軽くなります。<br>
Config_Reb_112_Name - エフェクトの歪み表現
Config_Reb_112_Hint - エフェクトが空間を歪ませる効果の<br>ON/OFFを切り替えます。<br><br>OFFにすると処理がやや軽くなります。
Config_Reb_113_Name - 3Dレンダリング解像度
Config_Reb_113_Hint - 3D表示の解像度を設定します。<br><br>設定を“低”にすると処理がやや軽くなります。
Config_Reb_113_Select_0 - 低
Config_Reb_113_Select_1 - 中
Config_Reb_113_Select_2 - 高（標準）
Config_Reb_115_Name - エステでの体型変更の同期設定２
Config_Reb_115_Choices_0 - 自動的に切り替える
Config_Reb_115_Choices_1 - 個別に編集する
Config_Reb_115_Hint - エステで、コスチュームや<br>キャストのパーツなどを変更する時に、<br><yellow>『PSO2：NGS』と『PSO2』の体型<c>を<br>自動的に切り替えるか、<br>個別に編集するかを設定します。
Config_Reb_116_Name - タスク受注時のガイド切り替え
Config_Reb_116_Hint - NPCからタスクを受注した時に、<br>ガイド情報を自動的に切り替えるかを設定します。
Config_Reb_116_Select_0 - 切り替えない
Config_Reb_116_Select_1 - 切り替える
Config_Reb_045_Name - 通常視点：マウスの回転速度補正
Config_Reb_045_Hint - マウス操作時のカメラの回転速度を設定します。<br>数値を下げることで回転速度が遅くなります。<br><br><yellow>※通常視点にのみ適用されます。<c>
Config_Reb_046_Name - 肩越し視点：マウスの回転速度補正
Config_Reb_046_Hint - マウス操作時のカメラの回転速度を設定します。<br>数値を下げることで回転速度が遅くなります。<br><br><yellow>※肩越し視点にのみ適用されます。<c>
Config_Reb_118_Name - ダイブアタックの同時押し発動
Config_Reb_118_Hint - ダイブアタックを<%Jump>＋<%NormalAttack>で発動するかを設定します。<br>※ダイブアタックは、サブパレットに設定して<br>　使用することもできます。
Config_Reb_118_Select_0 - 使用しない
Config_Reb_118_Select_1 - 使用する
Config_Reb_119_Name - 探索セクションのキャラクター表示数
Config_Reb_119_Hint - 探索セクションで表示する<br>キャラクターの最大数を設定します。<br><br>数値を下げると処理がやや軽くなります。

Group 1
Subject_000 - Action Settings
Subject_001 - HUD Settings
Subject_002 - Menu Settings
Subject_003 - Auto Pick Up
Subject_004 - Other Settings
Subject_005 - Camera Settings
Subject_006 - Camera Rotation Speed (Left/Right)
Subject_007 - Camera Rotation Speed (Up/Down)
Subject_008 - Displays of Damage Dealt
Subject_009 - Displays of HP Recovery/Damage Taken
Subject_010 - Displays of EXP
Subject_011 - Obtained Item Display
Subject_012 - Confirmation Notifications
Subject_013 - Message Notifications
Subject_014 - Other Notifications
Subject_015 - Chat Settings
Subject_016 - Display Auto Chat from Other Users
Subject_017 - Channels Featured in "Display All" Log Window
Subject_018 - Screenshot Settings
Subject_019 - Salon Settings
Subject_020 - Ridroid Settings
Subject_021 - Dark Blast Settings
Subject_022 - BGM Volume
Subject_023 - Sound Effects Volume
Subject_024 - Voice Volume
Subject_025 - In-Game Video Playback Volume
Subject_026 - Playback Settings
Subject_027 - Graphics Features
Subject_028 - Max Detailed Model Display
Subject_029 - Max Photon Blast Display
Subject_030 - Reflection Quality
Subject_031 - Shadow Quality
Subject_032 - Screen Brightness
Subject_033 - Camera Lighting
Subject_034 - Mouse Correction
Subject_035 - Voice Chat ON/OFF
Subject_036 - ウィッシュリスト、プレゼントリストの表示/非表示*
Config_000_Name - Lock-On Mode
Config_000_Choices_0 - Single-press
Config_000_Choices_1 - Hold Down Key/Button
Config_000_Hint - Select how you would like to switch to Lock-On <br>mode. You can either switch Lock-On mode on/off <br>with a button/key press or have it activate only <br>while a button/key is held down.
Config_001_Name - Switch Lock-On Target Using <%RStick>
Config_001_Choices_0 - Enable
Config_001_Choices_1 - Disable
Config_001_Hint - Select whether to switch your lock-on target<br>using <%RStick> when locking on.
Config_002_Name - Back Palette Switching
Config_002_Hint - Select how you would like to switch to the Back Palette.<br>You can either switch to the Back Palette with a button/key<br>press or have it activate only while a button/key is held down.
Config_003_Name - Double-tap Dodging
Config_003_Choices_0 - Long Interval
Config_003_Choices_1 - Moderate Interval
Config_003_Choices_2 - Short Interval
Config_003_Choices_3 - Disabled
Config_003_Hint - Set the activation interval for Dodge Actions triggered<br>by pressing the individual character movement keys<br>(the [W]/[A]/[S]/[D] keys in the initial settings) twice<br>in quick succession.
Config_004_Name - Radar Map Rotation
Config_004_Choices_0 - Don't Rotate
Config_004_Choices_1 - Rotate
Config_004_Hint - Select whether the Radar Map will rotate along with the<br>camera.
Config_005_Name - Toggle Radar Map During Emergency Trials
Config_005_Choices_0 - Zoom Out
Config_005_Choices_1 - Don't Switch
Config_005_Hint - Select whether to zoom out on the Radar Map automatically<br>whenever an Emergency Trial is activated and the map is<br>zoomed in.
Config_006_Name - Display Sub-Palette Contents During Selection
Config_006_Choices_0 - Hide
Config_006_Choices_1 - Only display When Switching
Config_006_Choices_2 - Always Display
Config_006_Hint - Set how to display Sub-Palette content during selection.
Config_007_Name - Display Pet Parameters
Config_007_Choices_0 - Display
Config_007_Choices_1 - Hide
Config_007_Hint - Select whether to display HP and status icons for your pet.
Config_008_Name - Text Color for Character Names of Other Party Members
Config_008_Choices_0 - White
Config_008_Choices_1 - Blue
Config_008_Hint - Select the color of the names<br>of characters in other parties.
Config_009_Name - HP Bar Color Based on Elemental Attack Type
Config_009_Choices_0 - No element-based change
Config_009_Choices_1 - Elements change bar color
Config_009_Hint - Select whether the color of the HP bar will change<br>depending on whether damage was inflicted from a<br>Melee Attack, Ranged Attack, or Technique.
Config_010_Name - "Returning Player" Icon 
Config_010_Hint - Select whether to display a "Returning Player" icon.<br>*You can still receive Returning Player bonuses even if<br>the icon isn't displayed.
Config_011_Name - Storage Initial Cursor Position
Config_011_Choices_0 - All Storage
Config_011_Choices_1 - Default Storage
Config_011_Choices_2 - Character Storage
Config_011_Choices_3 - Premium Storage
Config_011_Choices_4 - OTP Storage
Config_011_Choices_5 - PSO2es Storage
Config_011_Hint - Select the initial cursor position in the Storage UI display when<br>accessing a Storage Terminal, selling items in your Personal<br>Shop, or buying or selling items at an NPC shop.
Config_012_Name - Simplified Gathering Information
Config_012_Hint - Select whether simplified Gathering info will be displayed<br>when the Main Menu is open.
Config_013_Name - Character Menu Display Format
Config_013_Choices_0 - Category View
Config_013_Choices_1 - Summary View
Config_013_Hint - Specify the display format used for Character Menus<br>displayed when selecting Nearby Characters, etc.
Config_014_Name - Quest Counter View
Config_014_Hint - Set Quest Counter View.
Config_015_Name - Party Settings Menu Display Type
Config_015_Choices_0 - Detailed
Config_015_Choices_1 - Normal
Config_015_Hint - Set the Party Settings menu display type.
Config_016_Name - Save Party Settings
Config_016_Choices_0 - Save
Config_016_Choices_1 - Don't Save
Config_016_Hint - Select whether the Party Settings are saved when <br>logging out or moving blocks. <br><br><yellow>Note: Saved Party Settings remain in effect until <br>you exit the game.<c><br><br><yellow>Note: Password settings remain in effect until <br>you logout even you select "Don't Save".<c>
Config_017_Name - Party Naming When Accepting Quests
Config_017_Choices_0 - Quest Name
Config_017_Choices_1 - Character Name
Config_017_Hint - Select the party name that will be automatically used <br>when a quest is accepted but a party name has not been <br>previously specified.<br><br>[Quest Name]<br>The name of the accepted quest will be displayed.<br><br>[Character Name]<br>The name of the character who accepted the quest will <br>be displayed.
Config_018_Name - Initial Cursor Position When Accepting Quests
Config_018_Choices_0 - Search Multiple Blocks
Config_018_Choices_1 - Accept in Current Block
Config_018_Hint - Select initial cursor position when accepting<br>quests that support multi-block matchmaking.<br>*Does not apply to some quests
Config_019_Name - Meseta Auto-Looting
Config_019_Choices_0 - Disable
Config_019_Choices_1 - Enable
Config_019_Hint - Select whether to activate the meseta auto-loot function.
Config_020_Name - Immediate Weapon Acquisition
Config_020_Choices_0 - Disable
Config_020_Choices_1 - Use When 13★ Or Greater
Config_020_Hint - Select whether to gather weapons of Rarity 13 or above<br>automatically in your character's inventory instead of<br>letting them drop on the field and risk missing them.
Config_021_Name - Immediate Unit Acquisition
Config_021_Choices_0 - Disable
Config_021_Choices_1 - Use When 12★ Or Greater
Config_021_Hint - Select whether to gather Units of Rarity 13 or above<br>automatically in your character's inventory instead of<br>letting them drop on the field and risk missing them.
Config_022_Name - Immediate Material Item Acquisition
Config_022_Hint - Selects whether to move Client Order<br>items / materials to your inventory<br>automatically without dropping<br>onto the field to avoid missing them.
Config_023_Name - Immediate Acquisition of Other Items
Config_023_Hint - Select whether to gather high-rarity items (other than<br>weapons, Units, or materials) automatically, moving them<br>to your character's inventory instead of letting them drop<br>on the field and risk missing them.
Config_024_Name - Display Rare Drop Animations
Config_024_Choices_0 - 7★ or Greater
Config_024_Choices_1 - 10★ or Greater
Config_024_Choices_2 - 13★ or Greater
Config_024_Hint - Select whether to feature different animations<br>according to Rarity for rare item drops.
Config_025_Name - Event Focus Function
Config_025_Hint - Select whether to focus on story events when holding the<br>access button.
Config_026_Name - In-game Monitor Video Playback
Config_026_Choices_0 - Play
Config_026_Choices_1 - Don't Play
Config_026_Hint - Select whether videos will play on the monitor in <br>location such as cities.
Config_027_Name - Prioritize Beginner Blocks Upon Login
Config_027_Choices_0 - Prioritize
Config_027_Choices_1 - Don't Prioritize
Config_027_Hint - Select whether to prioritize selection of a Beginner Block<br>when logging in as a character under Level 20.
Config_028_Name - Max Photon Blast Display
Config_028_Choices_0_VITA - Display Everyone's
Config_028_Choices_1_VITA - Display Only Your Own
Config_028_Hint_VITA - Set whether to display other player's Photon Blasts.
Config_029_Name - Mouse Camera Control
Config_029_Choices_0 - Prioritize camera operation
Config_029_Choices_1 - Prioritize cursor operation
Config_029_Hint - Select whether to prioritize camera operation or mouse cursor<br>operation when using mouse controls.
Config_030_Name - Camera Rotation (Left/Right)
Config_030_Choices_0 - Standard
Config_030_Choices_1 - Inverted
Config_030_Hint - Select controls for camera left/right rotation.
Config_031_Name - Camera Rotation (Up/Down)
Config_031_Hint - Select controls for camera up/down rotation.
Config_032_Hint - Adjust the speed of the camera's left/right rotation.
Config_033_Hint - Adjust the speed of the camera's up/down rotation.
Config_034_Name - Mouse Camera Control
Config_035_Name - Camera Rotation (Left/Right)
Config_036_Name - Camera Rotation (Up/Down)
Config_039_Name - Player Character
Config_039_Choices_0 - Large (Standard)
Config_039_Choices_1 - Medium
Config_039_Choices_2 - Small
Config_039_Choices_3 - Hide
Config_039_Hint - Set the size of the text that displays when you deal damage.
Config_040_Name - Party Members
Config_041_Name - Other Characters
Config_042_Name - Player Character
Config_042_Hint - Set the size of the text that displays when you receive<br>damage or healing.
Config_043_Name - Party Members
Config_044_Name - Other Characters
Config_045_Name - EXP / Other
Config_045_Hint - Set the size of the text that displays when you obtain EXP.
Config_046_Name - Item Acquisition
Config_046_Choices_0 - Display Beside Character
Config_046_Choices_1 - Display at Item Location
Config_046_Choices_2 - Hide
Config_046_Hint - Set the placement of the display that comes up when<br>you obtain an item.
Config_047_Name - Party Invitation
Config_047_Hint - Specify whether to display a new notification <br>whenever you receive an invitation to join a party.
Config_048_Name - Friend Request Notifications
Config_048_Hint - Specify whether to display a new notification <br>whenever you receive a Friend Request.
Config_049_Name - Alliance Scouting Notifications
Config_049_Hint - Specify whether to display a new notification <br>whenever you are scouted by an alliance.
Config_050_Name - Group Chat Invitation
Config_050_Hint - Specify whether to display a selection window<br>whenever you receive an invitation to join Group Chat.
Config_051_Name - Trade Request Sent
Config_051_Hint - Specify whether to display a selection window<br>whenever you receive a Trade Request.
Config_052_Name - Recommended Orders Notifications
Config_052_Hint - Select whether to display the Recommended Client<br>Orders window when accepting a Recommended Quest.
Config_053_Name - Multi-Block Matchmaking Acceptance Confirmation
Config_053_Hint - Select whether to display a confirmation window<br>whenever the Party Leader accepts a quest<br>that supports multi-block matchmaking.
Config_054_Name - <%GamePad> Settings Notifications
Config_054_Hint - Select whether to display a notification whenever the<br>assignment of important operations on the <%GamePad><br>creates an issue and the control settings must be<br>automatically restored.
Config_055_Name - Notification Message Display Number
Config_055_Choices_0 - 1
Config_055_Choices_1 - 3
Config_055_Hint - Select how many notification messages to receive at once.
Config_056_Name - Display Log When Items Acquired
Config_056_Hint - Select whether to display a notice in the log<br>each time you acquire an item.
Config_057_Name - Party Rare Item Acquisition Notification
Config_057_Hint - Select whether to receive a notification<br>whenever a party member acquires a Rare Item.
Config_058_Name - Premium Set Expiration Notice
Config_058_Hint - Select whether to receive a notification upon login<br>when your premium set is valid for more than 7 days.
Config_059_Name - Login Announcement
Config_059_Choices_0 - Send
Config_059_Choices_1 - Don't Send
Config_059_Hint - Select whether to send login announcements to Friends<br>whenever you log in.
Config_060_Name - Notification of Other Players' Incapacitation
Config_060_Hint - Select whether to enable notifications when other<br>players, including party members, are incapacitated. 
Config_061_Name - Notification of Your Incapacitation
Config_061_Hint - Select whether to display an icon to nearby players when<br>you are incapacitated.<br><br><yellow>Note: Icon will not be displayed if other<br>players have the "Incapacitation Notifications for Other<br>Players" setting switched off.<c>
Config_062_Name - Direct Chat
Config_062_Hint - Enabling this function will allow you to use your <br>keyboard to chat directly with other players <br>instead of moving your character and performing <br>other actions.
Config_063_Name - Toggle Direct Chat Key
Config_063_Hint - Select whether to toggle Direct Chat activation via the<br>[Scroll Lock] key. If Direct Chat is not functioning properly,<br>turning this setting on may resolve the problem.
Config_064_Name - Quote Messages in Replies
Config_064_Choices_0 - Quote
Config_064_Choices_1 - Don't Quote
Config_064_Hint - Select whether to quote the original message<br>in replies.
Config_065_Name - Symbol Art Comment Display
Config_065_Hint - Select whether to display Symbol Art comments.
Config_066_Name - Alliance Chat Balloon Display
Config_066_Choices_0 - Display All
Config_066_Choices_1 - Immediate Area Messages Only
Config_066_Choices_2 - Hide
Config_066_Hint - Specify conditions for displaying Alliance Chat balloons.
Config_067_Name - Group Chat Balloon Display
Config_067_Hint - Specify conditions for displaying Group Chat balloons.
Config_068_Name - Group/Alliance/Whisper Speaker Name
Config_068_Choices_0 - Player ID Name
Config_068_Choices_1 - Character Name
Config_068_Hint - Select whether to display your Player ID<br>or Character Name when participating in<br>Group Chat, Alliance Chat, or Whisper Chat.
Config_069_Name - Chat Input Background Color
Config_069_Choices_0 - Do Not Match Channel Color
Config_069_Choices_1 - Match Channel Color
Config_069_Hint - Select whether to change the color of the chat input<br>background depending on the recipient.
Config_070_Name - Group Chat Invitation On/Off
Config_070_Choices_0 - Accept
Config_070_Choices_1 - Don't Accept
Config_070_Hint - Select whether to receive Group Chat invitations.<br>If set to reject invitations, you will not receive any.
Config_071_Name - Auto Chat Usage
Config_071_Hint - Select whether to use Auto Chat.<br><br><yellow>Selecting "Not Used" for this setting will prevent<br>Auto Chat messages from being sent, even if configured.<c>
Config_072_Name - Show Auto Chat in Log
Config_072_Hint - Select whether to show Auto Chat messages in<br>the log.
Config_073_Name - Log Window Display Order
Config_073_Choices_0_VITA - Display Newest Entries at Top
Config_073_Choices_1_VITA - Display Newest Entries at Bottom
Config_073_Hint_VITA - Select the display order of logs.
Config_074_Name - Events
Config_074_Hint - Select whether to display certain categories of Auto Chat<br>messages from other players.
Config_075_Name - Members
Config_076_Name - Actions
Config_077_Name - Area
Config_077_Hint - Specify content to be displayed in the "Display All"<br>Log Window.
Config_078_Name - Party
Config_079_Name - Alliance
Config_080_Name - Whisper
Config_081_Name - System
Config_082_Name - Characters
Config_083_Name - Group Chat
Config_084_Name - Screenshot Capture Format
Config_084_Choices_0 - JPG
Config_084_Choices_1 - PNG
Config_084_Choices_2 - BMP
Config_084_Hint - Select the image format used when saving screenshots.
Config_085_Name - UI Display When Taking Screenshots
Config_085_Choices_0 - Display All
Config_085_Choices_1 - Display Balloons Only
Config_085_Choices_2 - Hide
Config_085_Hint - Select whether to display the UI (windows, interfaces, etc.)<br>on screenshots.<br>Note: This setting affects the screenshot function only.
Config_085_Choices_0_Switch - Display Windows
Config_085_Choices_1_Switch - Do Not Display Windows
Config_085_Hint_Switch - Select whether to display the UI (windows, interfaces, etc.)<br>on screenshots.<br>Note: This setting affects the screenshot function only.
Config_086_Name - Body Type Synchronization in Salon I
Config_086_Choices_0 - Synchronize Automatically
Config_086_Choices_1 - Edit Models Separately
Config_086_Hint - Select whether to automatically switch between <yellow>human <br>and CAST body types<c> or edit them individually when <br>changing outfits, CAST parts, etc. in the Salon.
Config_087_Name - Control Settings
Config_087_Choices_0 - Manual
Config_087_Choices_1 - Auto
Config_087_Hint - Select Ridroid control settings.<br><br>Manual: Ridroid advances manually.<br>Auto: Ridroid advances automatically.<br><br>Note: Ridroids use the <yellow>Over-the-Shoulder View<c> as the default.
Config_088_Name - Standard View: Camera Rotation (Left/Right)
Config_088_Hint - Select controls for Ridroid camera rotation (left/right).
Config_089_Name - Standard View: Camera Rotation (Up/Down)
Config_089_Hint - Select controls for Ridroid camera rotation (up/down).
Config_090_Name - Standard View: Steering (Left/Right)
Config_090_Hint - Select controls for Ridroid steering (left/right).
Config_091_Name - Standard View: Movement (Up/Down)
Config_091_Hint - Select controls for Ridroid movement (up/down).
Config_092_Name - Over-the-Shoulder View: Camera Rotation (Left/Right)
Config_093_Name - Over-the-Shoulder View: Camera Rotation (Up/Down)
Config_094_Name - Over-the-Shoulder View: Steering (Left/Right)
Config_095_Name - Over-the-Shoulder View: Movement (Up/Down)
Config_096_Name - Unique Voice for Dark Blasts
Config_096_Hint - Select whether to play unique voice samples whenever<br>a Dark Blast is activated.
Config_097_Name - Display Type for Others' Dark Blasts
Config_097_Choices_0 - Default to Others' Settings
Config_097_Choices_1 - Display Aura
Config_097_Choices_2 - Display Character
Config_097_Hint - Set how other players' Dark Blasts appear.<br><br>[Default to Others' Settings]<br>Display according to other players' settings.<br><br>[Display Aura]<br>Display Dark Blasts as an aura.<br>The transparency of the aura will be determined by other<br>players' settings.<br><br>[Display Character]<br>Always display the character and do not show Dark Blasts.<br><br>This setting will not be applied if<br>[Graphics] > [Shader Quality] is set to "Simple."
Config_097_Hint_PS4 - Set how other players' Dark Blasts appear.<br><br>[Default to Others' Settings]<br>Display according to other players' settings.<br><br>[Display Aura]<br>Display Dark Blasts as an aura.<br>The transparency of the aura will be determined by other<br>players' settings.<br><br>[Display Character]<br>Always display the character and do not show Dark Blasts.
Config_097_Hint_Switch - Set how other players' Dark Blasts appear.<br><br>[Default to Others' Settings]<br>Display according to other players' settings.<br><br>[Display Aura]<br>Display Dark Blasts as an aura.<br>The transparency of the aura will be determined by other<br>players' settings.<br><br>[Display Character]<br>Always display the character and do not show Dark Blasts.
Config_097_Hint_PCCloud - Set how other players' Dark Blasts appear.<br><br>[Default to Others' Settings]<br>Display according to other players' settings.<br><br>[Display Aura]<br>Display Dark Blasts as an aura.<br>The transparency of the aura will be determined by other<br>players' settings.<br><br>[Display Character]<br>Always display the character and do not show Dark Blasts.
Config_098_Hint - Adjust the volume of background music.
Config_099_Hint - Adjust the volume of sound effects.
Config_100_Hint - Adjust the volume of voices and dialogue.
Config_101_Hint - Adjust the volume of videos shown in-game, including on<br>the giant monitor in the ARKS Lobby.
Config_102_Name - Surround Sound
Config_102_Choices_0 - On
Config_102_Choices_1 - Off
Config_102_Hint - Turn surround sound on/off.
Config_103_Name - Global Focus Sound Playback
Config_103_Hint - Specify whether to play game audio when the<br>game is not in the active window.
Config_104_Name - Effect Light Source
Config_104_Hint - Switch lighting for special effects on/off.<br><br>Switching these effects off reduces the processing load.
Config_105_Name - Terrain Lighting
Config_105_Hint - Switch terrain lighting on/off.<br>Switching these effects off reduces the processing load.
Config_105_Hint_PS4 - Switch terrain lighting on/off.<br>Switching these effects off reduces the processing load.
Config_105_Hint_Switch - Switch terrain lighting on/off.
Config_105_Hint_PCCloud - Switch terrain lighting on/off.
Config_106_Name - Bloom
Config_106_Hint - Switch the filter for bright areas to improve the overall <br>appearance of onscreen images on/off.<br><br>Switching this effect off reduces the processing load.
Config_106_Hint_PS4 - Switch the filter for bright areas to improve the overall <br>appearance of onscreen images on/off.<br><br>Switching this effect off reduces the processing load.
Config_107_Name - Depth of Field
Config_107_Hint - Switch the background blur effect for certain events on/off.<br><br>Switching this effect off reduces the processing load.
Config_107_Hint_PS4 - Switch the background blur effect for certain events on/off.<br><br>Switching this effect off reduces the processing load.
Config_108_Name - Blur
Config_108_Hint - Switch the afterimage-like effect when the camera or<br>character moves on/off.<br><br>Switching this effect off reduces the processing load.
Config_109_Name - Light Rays
Config_109_Hint - Switch the display of light rays emanating from the sun on/off.<br>Switching this effect off reduces the processing load.
Config_109_Hint_PS4 - Switch the display of light rays emanating from the sun on/off.<br>Switching this effect off reduces the processing load.
Config_110_Name - Anti-Aliasing
Config_110_Hint - Switch the function to display curved or slanted lines <br>smoothly on/off.<br>Switching this effect off reduces the processing load.<br><br><yellow>Note: Including TAA may change the appearance <br>of some of PSO2 items.<c>
Config_111_Name - Soft Particles
Config_111_Hint - Causes effect particles to fade as they approach the ground.<br>Only applicable to certain effects.<br><br>Switching this effect off reduces the processing load.
Config_111_Hint_PS4 - Causes effect particles to fade as they approach the ground.<br>Only applicable to certain effects.<br><br>Switching this effect off reduces the processing load.
Config_112_Name - Reduce Some Lighting Effects
Config_112_Choices_0 - Normal
Config_112_Choices_1 - Reduced
Config_112_Hint - Switch light patterns for some effects on/off.<br>Selecting "Reduced" results in more subdued patterns.
Config_112_Hint_Switch - Switch light patterns for some effects on/off.<br>Selecting "Reduced" results in more subdued patterns.
Config_112_Hint_PCCloud - Switch light patterns for some effects on/off.<br>Selecting "Reduced" results in more subdued patterns.
Config_113_Name - Display Range for Certain Effects from Players
Config_113_Choices_0 - Only Nearby Effects
Config_113_Choices_1 - Display All Effects
Config_113_Hint - Determine the display radius for some effects from other<br>players. Selecting "Display all effects" ensures effects will<br>be displayed at any distance.
Config_114_Name - Ambient Occlusion
Config_114_Hint - Switch precise drawing of the shadows on the edges of <br>objects on/off.<br><br>Switching this effect off reduces the processing load.
Config_114_Hint_PS4 - Switch precise drawing of the shadows on the edges of <br>objects on/off.<br><br>Switching this effect off reduces the processing load.
Config_115_Name - Screen Edge Darkening
Config_115_Hint - Switch the function to darken screen edges on/off.<br><br>Switching this effect off reduces the processing load.
Config_115_Hint_PS4 - Switch the function to darken screen edges on/off.<br><br>Switching this effect off reduces the processing load.
Config_116_Name - Color Tone Curve
Config_116_Hint - Switch the function to adjust the overall color tone, <br>contrast, and brightness for each field on/off.<br><br>Switching this effect off reduces the processing load.
Config_116_Hint_PS4 - Switch the function to adjust the overall color tone, <br>contrast, and brightness for each field on/off.<br><br>Switching this effect off reduces the processing load.
Config_116_Hint_Switch - Switch the function to adjust the overall color tone, <br>contrast, and brightness for each field on/off.<br><br>Switching this effect off reduces the processing load.
Config_116_Hint_PCCloud - Switch the function to adjust the overall color tone, <br>contrast, and brightness for each field on/off.<br><br>Switching this effect off reduces the processing load.
Config_117_Name - Edge Lighting
Config_117_Hint - Optimize the amount of light surrounding objects.<br><br>Switching this effect off reduces the processing load.<br><br>Shader quality must be set to high.
Config_117_Hint_PS4 - Optimize the amount of light surrounding objects.<br><br>Switching this effect off reduces the processing load.
Config_117_Hint_Switch - Optimize the amount of light surrounding objects.
Config_117_Hint_PCCloud - Optimize the amount of light surrounding objects.
Config_118_Name - Automatic Resolution Adjustment
Config_118_Hint_PS4 - Reduce resolution during periods of high workload<br>to maintain a high frame rate.<br><br>Switching this function off may produce low frame<br>rates in battle and elsewhere.
Config_119_Hint - Specify the number of detailed character models to <br>render.<br><br>Lower values reduce processing load.
Config_120_Hint - Specify the number of Photon Blasts to display.<br><br>Lower values reduce processing load.
Config_121_Hint - Adjust the quality of reflections on water surfaces.<br>Lower values reduce processing load.
Config_122_Hint - Adjust the level of precision of shadows falling on objects.<br><br>Lower values reduce processing load.
Config_124_Hint_PS4 - Adjust screen brightness.<br><br>Lower values reduce overall screen brightness.
Config_123_Hint - Adjust the amount of light where the camera is facing.<br><br>Setting this value to 0 reduces the processing load.
Config_125_Hint - Adjust camera rotation speed when operating the mouse.<br>Lower values reduce the speed at which the camera moves.
Config_127_Name - Hide Other Players' Accessories
Config_127_Choices_0 - Not Used
Config_127_Choices_1 - Blocked Characters 
Config_127_Choices_2 - All Characters
Config_127_Hint - Select whether other players' accessories are displayed.<br>Selecting either "Blocked Characters" or<br>"All Characters" will hide the accessories of those<br>characters.
Config_128_Name - Voice Chat Settings
Config_128_Choices_0 - Use
Config_128_Choices_1 - Not Used
Config_128_Hint - Select whether to use voice chat. If this is toggled<br>off, you will not be able to hear yourself or<br>other players.
Config_129_Name - Wish List/Gift List Options
Config_129_Choices_0 - Hide
Config_129_Choices_1 - Display
Config_129_Hint - Select whether to display "Add to Wish List"<br>or "Add to Gift List" in the item menu.
Config_130_Name - Auto Send to Material Storage
Config_130_Choices_0 - Use
Config_130_Choices_1 - Not Used
Config_130_Hint - Selects whether to send Client Order<br>items / materials to Material Storage<br>automatically upon acquisition.<br><br>Eligible Acquisitions:<br>-Item Drops<br>-Gathering<br>-E Trial Rewards<br>-Quest Result Rewards
Config_Reb_001_Name - Radar Map Rotation
Config_Reb_001_Hint - Select whether the Radar Map will rotate along<br>with the camera.
Config_Reb_001_Select_0 - Don't Rotate
Config_Reb_001_Select_1 - Rotate
Config_Reb_002_Name - HP Bar Color Based on Elemental Attack Type
Config_Reb_002_Hint - Select whether the color of the HP bar will change<br>depending on whether damage was inflicted from a<br>Melee Attack, Ranged Attack, or Technique.
Config_Reb_002_Select_0 - No element-based change
Config_Reb_002_Select_1 - Elements change bar color
Config_Reb_003_Name - Display Sub-Palette Icon Name
Config_Reb_003_Hint - Set how to display Sub-Palette content during selection.
Config_Reb_003_Select_0 - Hide
Config_Reb_003_Select_1 - Only Display When Switching
Config_Reb_003_Select_2 - Always Display
Config_Reb_004_Name - Display Rare Drop Animations
Config_Reb_004_Hint - Select whether to display animations for rare <br>item drops.
Config_Reb_004_Select_0 - Hide
Config_Reb_004_Select_1 - Sound Effects Only
Config_Reb_004_Select_2 - Display
Config_Reb_005_Name - Volumetric Fog
Config_Reb_005_Hint - Switch the light reflecting off of fog and dust on/off.<br><br>Switching this effect off reduces the processing load.
Config_Reb_006_Name - Character Menu Display Format
Config_Reb_006_Hint - Specify the display format used for Character Menus<br>displayed when selecting Nearby Characters, etc.
Config_Reb_006_Select_0 - Category View
Config_Reb_006_Select_1 - Summary View
Config_Reb_007_Name - "Returning Player" Icon 
Config_Reb_007_Hint - Select whether to display a "Returning Player" icon.<br>*You can still receive Returning Player bonuses even if<br>the icon isn't displayed.
Config_Reb_007_Select_0 - Hide
Config_Reb_007_Select_1 - Display
Config_Reb_008_Name - In-game Monitor Video Playback
Config_Reb_008_Hint - Select whether videos will play on the monitor in <br>location such as cities.
Config_Reb_008_Select_0 - Don't play
Config_Reb_008_Select_1 - Play
Config_Reb_009_Name - Save Party Settings
Config_Reb_009_Hint - Select whether the Party Settings are saved when <br>logging out or moving blocks. <br><br><yellow>Note: Saved Party Settings remain in effect until <br>you exit the game.<c><br><br><yellow>Note: Password settings remain in effect until <br>you logout even you select "Don't Save".<c>
Config_Reb_009_Select_0 - Don't Save
Config_Reb_009_Select_1 - Save
Config_Reb_010_Name - Event Focus Function
Config_Reb_010_Hint - Select whether to focus on story events when holding the<br>access button.
Config_Reb_010_Select_0 - Disable
Config_Reb_010_Select_1 - Enable
Config_Reb_011_Name - Text Color for Character Names of Other Party Members
Config_Reb_011_Hint - Select the color of the names of characters in other parties.
Config_Reb_011_Select_0 - White
Config_Reb_011_Select_1 - Blue
Config_Reb_012_Name - Party Naming When Accepting Quests
Config_Reb_012_Hint - Select the party name that will be automatically used <br>when a quest is accepted but a party name has not<br>been previously specified.<br><br>[Quest Name]<br>The name of the accepted quest will be displayed.<br><br>[Character Name]<br>The name of the character who accepted the quest will <br>be displayed.
Config_Reb_012_Select_0 - Quest Name
Config_Reb_012_Select_1 - Character Name
Config_Reb_013_Name - Prioritize Beginner Blocks Upon Login
Config_Reb_013_Hint - Select whether to prioritize selection of a Beginner Block<br>when logging in as a character under Level 20.
Config_Reb_013_Select_0 - Don't Prioritize
Config_Reb_013_Select_1 - Prioritize
Config_Reb_014_Name - Storage Initial Cursor Position
Config_Reb_014_Hint - Select the initial cursor position in the Storage UI display when<br>accessing a Storage Terminal, selling items in your Personal<br>Shop, or buying or selling items at an NPC shop.
Config_Reb_014_Select_0 - All Storage
Config_Reb_014_Select_1 - Default Storage
Config_Reb_014_Select_2 - Character Storage
Config_Reb_014_Select_3 - Premium Storage
Config_Reb_014_Select_4 - OTP Storage
Config_Reb_014_Select_5 - PSO2es Storage
Config_Reb_015_Name - Initial Cursor Position When Accepting Quests
Config_Reb_015_Hint - Select initial cursor position when accepting<br>quests that support multi-block matchmaking.<br>*Does not apply to some quests
Config_Reb_015_Select_0 - Search Multiple Blocks
Config_Reb_015_Select_1 - Accept in Current Block
Config_Reb_016_Name - Party Invitation Notifications
Config_Reb_016_Hint - Specify whether to display a new notification <br>whenever you receive an invitation to join a party.
Config_Reb_016_Select_0 - Hide
Config_Reb_016_Select_1 - Display
Config_Reb_017_Name - Friend Request Notifications
Config_Reb_017_Hint - Specify whether to display a new notification <br>whenever you receive a Friend Request.
Config_Reb_017_Select_0 - Hide
Config_Reb_017_Select_1 - Display
Config_Reb_018_Name - Alliance Scouting Notifications
Config_Reb_018_Hint - Specify whether to display a new notification <br>whenever you are scouted by an alliance.
Config_Reb_018_Select_0 - Hide
Config_Reb_018_Select_1 - Display
Config_Reb_020_Name - Display Log When Items Acquired
Config_Reb_020_Hint - Select whether to display a notice in the log<br>each time you acquire an item.
Config_Reb_020_Select_0 - Hide
Config_Reb_020_Select_1 - Display
Config_Reb_021_Name - Premium Set Expiration Notice
Config_Reb_021_Hint - Select whether to receive a notification upon login<br>when your premium set is valid for more than 7 days.
Config_Reb_021_Select_0 - Hide
Config_Reb_021_Select_1 - Display
Config_Reb_022_Name - Recommended Order Notification
Config_Reb_022_Hint - Select whether to display the Acceptance Menu <br>when accepting a Recommended Order.
Config_Reb_022_Select_0 - Hide
Config_Reb_022_Select_1 - Display
Config_Reb_023_Name - Party Rare Item Acquisition Notification
Config_Reb_023_Hint - Select whether to receive a notification<br>whenever a party member acquires a Rare Item.
Config_Reb_023_Select_0 - Hide
Config_Reb_023_Select_1 - Display
Config_Reb_024_Name - Multi-Block Matchmaking Acceptance Confirmation
Config_Reb_024_Hint - Select whether to display a confirmation window<br>whenever the Party Leader accepts a quest<br>that supports multi-block matchmaking.
Config_Reb_024_Select_0 - Hide
Config_Reb_024_Select_1 - Display
Config_Reb_025_Name - Login Announcement
Config_Reb_025_Hint - Select whether to send login announcements to<br>Friends whenever you log in.
Config_Reb_025_Select_0 - Don't Send
Config_Reb_025_Select_1 - Send
Config_Reb_026_Name - Notification of Other Players' Incapacitation
Config_Reb_026_Hint - Select whether to enable notifications when other<br>players, including party members, are incapacitated. 
Config_Reb_026_Select_0 - Hide
Config_Reb_026_Select_1 - Display
Config_Reb_027_Name - Notification of Your Incapacitation
Config_Reb_027_Hint - Select whether to display an icon to nearby players when you are incapacitated.<br><br><yellow>Note: Icon will not be displayed if other players have the "Incapacitation Notifications for Other Players" setting switched off.<c>
Config_Reb_027_Select_0 - Hide
Config_Reb_027_Select_1 - Display
Config_Reb_028_Name - Body Type Synchronization in Salon I
Config_Reb_028_Hint - Select whether to automatically switch between <yellow>human <br>and CAST body types<c> or edit them individually when <br>changing outfits, CAST parts, etc. in Salon.
Config_Reb_028_Select_0 - Synchronize Automatically
Config_Reb_028_Select_1 - Edit Models Separately
Config_Reb_029_Name - Lock-On Mode
Config_Reb_029_Hint - Select how you would like to switch to Lock-On <br>mode. You can either switch Lock-On mode on/off <br>with a button/key press or have it activate only <br>while a button/key is held down.
Config_Reb_029_Select_0 - Single-press
Config_Reb_029_Select_1 - Hold Down Key/Button
Config_Reb_030_Name - Switch Lock-On Target Using <%RStick>
Config_Reb_030_Hint - Select whether to switch your lock-on target<br>using <%RStick> when locking on.
Config_Reb_030_Select_0 - Disable
Config_Reb_030_Select_1 - Enable
Config_Reb_031_Name - Back Palette Switching
Config_Reb_031_Hint - Select how you would like to switch to the Back<br>Palette. You can either switch to the Back Palette<br>with a button/key press or have it activate only<br>while a button/key is held down.
Config_Reb_031_Select_0 - Single-press
Config_Reb_031_Select_1 - Hold Down Key/Button
Config_Reb_032_Name - Double-tap Dodging
Config_Reb_032_Hint - Set the activation interval for Dodge Actions<br>triggered by pressing the individual character<br>movement keys (the [W]/[A]/[S]/[D] keys in<br>the initial settings) twice in quick succession.
Config_Reb_032_Select_0 - Long Interval
Config_Reb_032_Select_1 - Moderate Interval
Config_Reb_032_Select_2 - Short Interval
Config_Reb_032_Select_3 - Disabled
Config_Reb_033_Name - Standard View: Camera Rotation (Left/Right)
Config_Reb_033_Hint - Horizontal camera orientation settings.<br><br><yellow>Note: Standard View only.<c>
Config_Reb_033_Select_0 - Standard
Config_Reb_033_Select_1 - Inverted
Config_Reb_034_Name - Standard View: Camera Rotation (Up/Down)
Config_Reb_034_Hint - Vertical camera orientation settings.<br><br><yellow>Note: Standard View only.<c>
Config_Reb_034_Select_0 - Standard
Config_Reb_034_Select_1 - Inverted
Config_Reb_035_Name - Standard View: Camera Rotation Speed (Left/Right)
Config_Reb_035_Hint - Horizontal camera rotation speed settings.<br>Lower values will rotate the camera slower.<br><br><yellow>Note: Standard View only.<c>
Config_Reb_036_Name - Standard View: Camera Rotation Speed (Up/Down)
Config_Reb_036_Hint - Vertical camera rotation speed settings.<br>Lower values will rotate the camera slower.<br><br><yellow>Note: Standard View only.<c>
Config_Reb_037_Name - Standard View: Mouse Priority Control
Config_Reb_037_Hint - Select whether to prioritize camera movement or the <br>mouse cursor when you use your mouse.<br><br><yellow>Note: Standard View only.<c>
Config_Reb_037_Select_0 - Camera
Config_Reb_037_Select_1 - Mouse Cursor
Config_Reb_038_Name - Over-the-Shoulder View: Camera Rotation (Left/Right)
Config_Reb_038_Hint - Horizontal camera orientation settings.<br><br><yellow>Note: Over-the-Shoulder View only.<c>
Config_Reb_038_Select_0 - Standard
Config_Reb_038_Select_1 - Inverted
Config_Reb_039_Name - Over-the-Shoulder View: Camera Rotation (Up/Down)
Config_Reb_039_Hint - Vertical camera orientation settings.<br><br><yellow>Note: Over-the-Shoulder View only.<c>
Config_Reb_039_Select_0 - Standard
Config_Reb_039_Select_1 - Inverted
Config_Reb_040_Name - Over-the-Shoulder View: Camera Rotation Speed (Left/Right)
Config_Reb_040_Hint - Horizontal camera rotation speed settings.<br>Lower values will rotate the camera slower.<br><br><yellow>Note: Over-the-Shoulder View only.<c>
Config_Reb_041_Name - Over-the-Shoulder View: Camera Rotation Speed (Up/Down)
Config_Reb_041_Hint - Vertical camera rotation speed settings.<br>Lower values will rotate the camera slower.<br><br><yellow>Note: Over-the-Shoulder View only.<c>
Config_Reb_042_Name - Over-the-Shoulder View: Mouse Priority Control
Config_Reb_042_Hint - Select whether to prioritize camera movement or the <br>mouse cursor when you use your mouse.<br><br><yellow>Note: Over-the-Shoulder View only.<c>
Config_Reb_042_Select_0 - Camera
Config_Reb_042_Select_1 - Mouse Cursor
Config_Reb_047_Name - Direct Chat Usage
Config_Reb_047_Hint - Set whether to use the keyboard only for text input <br>such as chatting.<br><br><yellow>Note: Selecting "Use" will disable the function <br>for actions such as character movement.<c><br>
Config_Reb_047_Select_0 - Not Used
Config_Reb_047_Select_1 - Use
Config_Reb_048_Name - Auto Chat Usage
Config_Reb_048_Hint - Select whether to use Auto Chat.<br><br><yellow>Selecting "Not Used" for this setting will prevent<br>Auto Chat messages from being sent, even if configured.<c>
Config_Reb_048_Select_0 - Not Used
Config_Reb_048_Select_1 - Use
Config_Reb_049_Name - Other Player Auto Chat Display Settings: Event
Config_Reb_049_Hint - Select whether to display other players' "Event" Auto Chats.
Config_Reb_049_Select_0 - Hide
Config_Reb_049_Select_1 - Display
Config_Reb_091_Name - Other Player Auto Chat Display Settings: Members
Config_Reb_091_Hint - Select whether to display other players' "Member" Auto Chats.
Config_Reb_091_Select_0 - Hide
Config_Reb_091_Select_1 - Display
Config_Reb_092_Name - Other Player Auto Chat Display Settings: Action
Config_Reb_092_Hint - Select whether to display other players' "Action" Auto Chats.
Config_Reb_092_Select_0 - Hide
Config_Reb_092_Select_1 - Display
Config_Reb_050_Name - Show Auto Chat in Log
Config_Reb_050_Hint - Select whether to show Auto Chat messages in<br>the log.
Config_Reb_050_Select_0 - Hide
Config_Reb_050_Select_1 - Display
Config_Reb_051_Name - Quote Messages in Replies
Config_Reb_051_Hint - Select whether to quote the other person's message<br>in replies.
Config_Reb_051_Select_0 - Don't Quote
Config_Reb_051_Select_1 - Quote
Config_Reb_053_Name - Alliance Chat Balloon Display
Config_Reb_053_Hint - Select whether to display Alliance Chat balloons.
Config_Reb_053_Select_0 - Display All
Config_Reb_053_Select_1 - Immediate Area Messages Only
Config_Reb_053_Select_2 - Hide
Config_Reb_054_Name - Displaying Symbol Art
Config_Reb_054_Hint - Select whether to display Symbol Art.<br><br><yellow>Note: Selecting "Hide" will also hide your own<br>Symbol Art.<c>
Config_Reb_054_Select_0 - Hide
Config_Reb_054_Select_1 - Display
Config_Reb_055_Name - Displaying Chat Speaker Name
Config_Reb_055_Hint - Select whether to display speaker names in<br>Group Chat, Alliance Chat, or Whisper Chat.
Config_Reb_055_Select_0 - Player ID Name
Config_Reb_055_Select_1 - Character Name
Config_Reb_056_Name - Chat Input Background Color
Config_Reb_056_Hint - Set whether to change the background color of the chat field for each type, such as Party Chat, Alliance Chat, etc.
Config_Reb_056_Select_0 - Do Not Change Color
Config_Reb_056_Select_1 - Change Color
Config_Reb_057_Name - BGM Volume
Config_Reb_057_Hint - Adjust the volume of background music.
Config_Reb_058_Name - Sound Effects Volume
Config_Reb_058_Hint - Adjust the volume of sound effects.
Config_Reb_059_Name - Voice Volume
Config_Reb_059_Hint - Adjust the volume of voices and dialogue.
Config_Reb_060_Name - In-Game Video Volume
Config_Reb_060_Hint - Adjust the volume for in-game videos.
Config_Reb_061_Name - Surround Sound
Config_Reb_061_Hint - Turn surround sound on/off.
Config_Reb_061_Select_0 - Off
Config_Reb_061_Select_1 - On
Config_Reb_062_Name - Global Focus Sound
Config_Reb_062_Hint - Specify whether to play game audio when the<br>game is not in the active window.
Config_Reb_062_Select_0 - Off
Config_Reb_062_Select_1 - On
Config_Reb_063_Name - Screenshot Capture Format
Config_Reb_063_Hint - Select the image format used when saving screenshots.
Config_Reb_063_Select_0 - JPG
Config_Reb_063_Select_1 - PNG
Config_Reb_063_Select_2 - BMP
Config_Reb_064_Name - UI Display When Taking Screenshots
Config_Reb_064_Hint - Select whether to display the UI (windows, <br>interfaces, etc.) on saving screenshots.<br><yellow>Note: This setting affects the in-game <br>screenshot function only.<c>
Config_Reb_064_Select_0 - Display All
Config_Reb_064_Select_1 - Display Balloons Only
Config_Reb_064_Select_2 - Hide
Config_Reb_065_Name - Effect Light Source
Config_Reb_065_Hint - Switch lighting for special effects on/off.<br>Switching these effects off reduces the <br>processing load.
Config_Reb_065_Select_0 - Off
Config_Reb_065_Select_1 - On
Config_Reb_066_Name - Terrain Lighting
Config_Reb_066_Hint - Switch terrain lighting on/off.<br>Switching these effects off reduces the <br>processing load.
Config_Reb_066_Select_0 - Off
Config_Reb_066_Select_1 - On
Config_Reb_067_Name - Bloom
Config_Reb_067_Hint - Switch the filter to bright areas to improve the overall <br>appearance of onscreen images on/off.<br><br>Switching this effect off reduces the processing load.
Config_Reb_067_Select_0 - Off
Config_Reb_067_Select_1 - On
Config_Reb_068_Name - Depth of Field
Config_Reb_068_Hint - Switch the background blur effect for certain events on/off.<br><br>Switching this effect off reduces the processing load.
Config_Reb_068_Select_0 - Off
Config_Reb_068_Select_1 - On
Config_Reb_069_Name - Blur
Config_Reb_069_Hint - Switch the afterimage-like effect when the camera or<br>character moves on/off.<br><br>Switching this effect off reduces the processing load.
Config_Reb_069_Select_0 - Off
Config_Reb_069_Select_1 - On
Config_Reb_070_Name - Light Rays
Config_Reb_070_Hint - Switch the display of light rays emanating from the sun on/off.<br><br>Switching this effect off reduces the processing load.
Config_Reb_070_Select_0 - Off
Config_Reb_070_Select_1 - On
Config_Reb_071_Name - Anti-Aliasing
Config_Reb_071_Hint - Switch the function to display curved or slanted lines <br>smoothly on/off.<br>Switching this effect off reduces the processing load.<br><br><yellow>Note: Including TAA may change the appearance <br>of some of PSO2 items.<c>
Config_Reb_071_Select_0 - OFF
Config_Reb_071_Select_1 - FXAA
Config_Reb_071_Select_2 - TAA
Config_Reb_071_Select_3 - TAA + FXAA
Config_Reb_074_Name - Ambient Occlusion
Config_Reb_074_Hint - Switch the precise drawing of object edge shadows on/off.<br><br>Switching this effect off reduces the processing load.
Config_Reb_074_Select_0 - Off
Config_Reb_074_Select_1 - On
Config_Reb_075_Name - Screen Edge Darkening
Config_Reb_075_Hint - Switch the function to darken screen edges on/off.<br><br>Switching this effect off reduces the processing load.
Config_Reb_075_Select_0 - Off
Config_Reb_075_Select_1 - On
Config_Reb_076_Name - Color Tone Curve
Config_Reb_076_Hint - Switch the function to adjust the overall color tone, <br>contrast, and brightness for each field on/off.<br><br>Switching this effect off reduces the processing load.
Config_Reb_076_Select_0 - Off
Config_Reb_076_Select_1 - On
Config_Reb_078_Name - Automatic Resolution Adjustment
Config_Reb_078_Hint - Switch the function to reduce resolution during periods of high workload to maintain frame rate on/off.<br><br>Switching this function off may produce low frame<br>rates in battle and elsewhere.
Config_Reb_078_Select_0 - Off
Config_Reb_078_Select_1 - On
Config_Reb_079_Name - Max Detailed Model Display
Config_Reb_079_Hint - Specify the number of detailed character models to <br>render.<br><br>Lower values reduce processing load.
Config_Reb_080_Name - Other Players' Effects Opacity
Config_Reb_080_Hint - Adjust the opacity of the effects occuring around<br>other players.<br><br>Lower values decreases effect opacity.
Config_Reb_081_Name - Shadow Quality
Config_Reb_081_Hint - Adjust the level of precision of shadows falling on objects.<br><br>Lower values reduce processing load.
Config_Reb_082_Name - Camera Lighting
Config_Reb_082_Hint - Adjust the amount of light where the camera <br>is facing.<br><br>Setting this value to 0 reduces the processing load.
Config_Reb_083_Name_old - Enemy Marker Display
Config_Reb_083_Hint_old - Adjust Enemy Marker Display settings on the Radar Map.
Config_Reb_083_Select_0 - Hide
Config_Reb_083_Select_1 - Only Display When Switching
Config_Reb_084_Name - Combat Guide Icon Display
Config_Reb_084_Hint - Select to display guide icons such as<br>T Marker (Trial Marker) and E Marker<br>(Enemy Marker) on the screen. 
Config_Reb_084_Select_0 - Display
Config_Reb_084_Select_1 - Temporary Display
Config_Reb_084_Select_2 - Hide
Config_Reb_085_Name - Auto Wall Kick
Config_Reb_085_Hint - Select whether to wall kick automatically or manually.
Config_Reb_085_Select_0 - Auto
Config_Reb_085_Select_1 - Manual
Config_Reb_083_Name - Camera Shake
Config_Reb_083_Hint - Set camera shake effect for enemy attacks, etc.<br><br><yellow>*Does not apply to event scenes.<c>
Config_Reb_086_Name - Boss Camera Controls
Config_Reb_086_Hint - Set whether change camera to a wide angle during combat with large Enemies.
Config_Reb_086_Select_0 - Off
Config_Reb_086_Select_1 - On
Config_Reb_089_Name - Lock-on Target Priority Settings
Config_Reb_089_Hint - Set whether lock-on target priority is given to the <br>direction the camera is facing or the direction the <br>character is facing.
Config_Reb_089_Select_0 - Camera Direction
Config_Reb_089_Select_1 - Character Direction
Config_Reb_090_Name - Stamp Audio Playback
Config_Reb_090_Hint - Select whether to play Stamps voices and sound effects.<br><br><yellow>Note: If "Mute all Stamps" is selected, you will not be <br>able to hear yourself or other players.<c>
Config_Reb_090_Select_0 - Play All
Config_Reb_090_Select_1 - Mute Only Nearby Stamps
Config_Reb_090_Select_2 - Mute All Stamps
Config_Reb_108_Name - Screen Space Reflection
Config_Reb_108_Hint - Switch precise drawing of the reflections off of some<br>terrain features on/off.<br><br>Switching this effect off reduces the processing load.
Config_Reb_106_Name - Screen Space Shadow
Config_Reb_106_Hint - Switch precise drawing of certain shadows falling on <br>objects on/off.<br><br>Switching this effect off reduces the processing load.
Config_Reb_093_Name - Cloud Quality
Config_Reb_093_Hint - Adjust the precision level for displaying clouds.<br><br>Lower values reduce processing load.
Config_Reb_093_Select_0 - Low
Config_Reb_093_Select_1 - Middle
Config_Reb_093_Select_2 - High
Config_Reb_094_Name - Particle Quality
Config_Reb_094_Hint - Adjust the display quality of particle effects.<br><br>Lower values reduce processing load.
Config_Reb_095_Name - Fur Rendering
Config_Reb_095_Hint - Switch precise drawing of some parts of character hair <br>on/off.<br><br>Switching this effect off reduces the processing load.
Config_Reb_096_Name - Specular Antialiasing
Config_Reb_096_Hint - Switch reflection noise reduction for clearer <br>drawing on/off.<br><br>Switching this effect off reduces the processing load.
Config_Reb_097_Name - Global Illumination
Config_Reb_097_Hint - Switch effect for creating more natural lighting effects <br>on/off.<br><br>Switching this effect off reduces the processing load.<br><br><yellow>Note: Changes will take effect the next time <br>you log in.<c>
Config_Reb_098_Name - Tesselation
Config_Reb_098_Hint - Switch precise drawing of some terrain undulations on/off.<br><br>Switching this effect off reduces the processing load.
Config_Reb_099_Name - V-Sync
Config_Reb_099_Hint - Reduces screen tearing.<br>Automatically disabled when the frame rate is <br>lower than the display refresh rate.
Config_Reb_100_Name - Texture Filtering
Config_Reb_100_Hint - Adjust the texture smoothness.<br><br>Processing load varies based on the setting.<br>Setting this to bilinear reduces the processing load.<br><yellow>Note: Changes will take effect the next time you <br>log in.<c>
Config_Reb_100_Select_0 - Bilinear
Config_Reb_100_Select_1 - Trilinear
Config_Reb_100_Select_2 - Anisotropy x4
Config_Reb_100_Select_3 - Anisotropy x8
Config_Reb_100_Select_4 - Anisotropy x16
Config_Reb_101_Name - Texture Resolution
Config_Reb_101_Hint - Adjust texture resolution settings.<br><br>Lowering the setting reduces the processing load.<br><br><yellow>Note: Changes will take effect the next time <br>you log in.<c>
Config_Reb_101_Select_0 - Low
Config_Reb_101_Select_1 - Middle
Config_Reb_101_Select_2 - High
Config_Reb_101_Select_3 - Highest
Config_Reb_102_Name - Maximum Frame Rate
Config_Reb_102_Hint - Set your maximum frame rate.
Config_Reb_102_Select_0 - Unrestricted
Config_Reb_102_Select_1 - 30 fps
Config_Reb_102_Select_2 - 60 fps
Config_Reb_102_Select_3 - 90 fps
Config_Reb_102_Select_4 - 120 fps
Config_Reb_102_Select_5 - 144 fps
Config_Reb_102_Select_6 - 165 fps
Config_Reb_103_Name - Terrain Draw Distance
Config_Reb_103_Hint - Adjust draw distance settings for such as enemies <br>and terrains.<br><br>Lower values reduce processing load.
Config_Reb_104_Name - Inactive Frame Rate Restriction
Config_Reb_104_Hint - Switch frame rate restriction when the application <br>window is inactive on/off.
Config_Reb_104_Choices_0 - Disable
Config_Reb_104_Choices_1 - Enable
Config_Reb_105_Name - Screen Brightness
Config_Reb_105_Hint - Adjust the screen brightness settings.<br>Lowering the value will reduce the brightness.
Config_Reb_107_Name - Show Equipment
Config_Reb_107_Hint - Select whether to allow others nearby to see your equipment.
Config_Reb_107_Select_0 - Do Not Show
Config_Reb_107_Select_1 - Show
Config_Reb_109_Name - Simple Graphics Settings
Config_Reb_109_Hint - Adjusts overall graphics settings.
Config_Reb_109_Select_0 - Change
Config_Reb_110_Name - Hide Other Players' Accessories
Config_Reb_110_Select_0 - Do Not Hide
Config_Reb_110_Select_1 - Characters on PSO2 Block List 
Config_Reb_110_Select_2 - All Characters
Config_Reb_110_Hint - Select whether to <yellow>hide<c> other players' accessories.
Config_Reb_112_Name - Effect Distortion Rendering
Config_Reb_112_Hint - Switch the effect distorting the space on/off.<br><br>Switching this effect off reduces the processing load.
Config_Reb_113_Name - 3D Rendering Resolution
Config_Reb_113_Hint - Adjust 3D rendering resolution.<br><br>Lower setting reduces the processing load.
Config_Reb_113_Select_0 - Low
Config_Reb_113_Select_1 - Middle
Config_Reb_113_Select_2 - High (Standard)
Config_Reb_115_Name - Body Type Synchronization in Salon II
Config_Reb_115_Choices_0 - Synchronize Automatically
Config_Reb_115_Choices_1 - Edit Models Separately
Config_Reb_115_Hint - Select whether to automatically switch between <yellow>PSO2:NGS and PSO2 body types<c> or edit them individually when changing outfits, CAST parts, etc. in Salon.
Config_Reb_116_Name - Switching Info When Accepting Tasks
Config_Reb_116_Hint - Select whether to automatically switch info<br>when you accept tasks from NPCs.
Config_Reb_116_Select_0 - Do Not Switch
Config_Reb_116_Select_1 - Switch
Config_Reb_045_Name - Standard View: Mouse Rotation Correction
Config_Reb_045_Hint - Adjust camera rotation speed when operating the<br>mouse. Lower values will rotate the camera slower.<br><br><yellow>Note: Standard View only.<c>
Config_Reb_046_Name - Over-the-Shoulder View: Mouse Rotation Correction
Config_Reb_046_Hint - Adjust camera rotation speed when operating the<br>mouse. Lower values will rotate the camera slower.<br><br><yellow>Note: Over-the-Shoulder View only.<c>
Config_Reb_118_Name - Diving Attack With Simultaneous Button Inputs
Config_Reb_118_Hint - Select whether to perform a Diving Attack by pressing<br><%Jump> + <%NormalAttack>.<br>The Glide Attack can also be used via your Sub-Palette.
Config_Reb_118_Select_0 - Disable
Config_Reb_118_Select_1 - Enable
Config_Reb_119_Name - Number of Models Displayed: Exploration Sectors
Config_Reb_119_Hint - Adjust the maximum character models displayed<br>onscreen at the same time for Exploration Sectors.<br><br>Lower values reduce processing load.


InitActionStyle
Group 0
Title - アクションパレットのタイプ選択
Message - アクションパートの操作方法について<br>1ボタン1アクションの直感操作の3ボタンタイプと<br>PAボタン１つで手軽にPAコンボが発動できる<br>2ボタンタイプの二つから選ぶことが出来ます。<br><yellow>複雑な操作が苦手な方は2ボタン操作をお勧めします。<br>※3ボタンタイプ固定のクラスもあります。<c><br><br><green>この設定は「オプション」の「設定の初期化」から<br>いつでも変更することが出来ます。<c><br><br>どちらの操作タイプを使用しますか？
Button_2Button - 2ボタンタイプ
Button_3Button - 3ボタンタイプ

Group 1
Title - Action Palette Settings
Message - There are two control schemes available for<br>action sequences. The 3-button setup offers<br>more immediate control, with each action assigned<br>to its own button. The 2-button setup lets you<br>easily string together combos using a single PA button.<br><yellow>If you prefer simpler control schemes,<br>the 2-button setup may be for you.<br>Some classes require the 3-button setup.<c><br><br><green>You can change this setting anytime by opening<br>"Options" and choosing "Restore Default Settings."<c><br><br>Which setup would you prefer?
Button_2Button - 2-button setup
Button_3Button - 3-button setup


InitAnnSettings
Group 0
title - 操作ガイド表示タイプ設定

Group 1
title - Control Display Settings


InitOpeSettings
Group 0
title - おもに使用する操作機器選択
button1 - キーボード＆マウス
button2 - コントローラー
message - このゲームをコントローラーでプレイする場合は、<br>キーボードをチャット用にしたり、ほかいくつかの<br>操作をコントローラー用に自動設定できます。<br><br><green>この設定は、「オプション」の「設定の初期化」から<br>いつでも変更することができます。<c><br><br>どちらの操作機器をおもに使用しますか？

Group 1
title - Primary Control Device
button1 - Keyboard & mouse
button2 - Controller
message - If you choose to play PSO2 using a controller, you can use the keyboard to chat<br>while still having a number of other controls automatically set for your controller.<br><br><green>This setting can be changed at any time by selecting "Options,"<br>then "Restore Default Settings."<c><br><br>Which input device would you like to use?


PlayerStatus
Group 0
MiKakin - 未使用
IsPremium - <yellow>プレミアム有効期間中<c>
NonPremium - <red>プレミアム有効期限切れ<c>
KakinGire - <red>期限切れ<c>
NetCafe - <green>ネットカフェプレミアム<c>

Group 1
MiKakin - Unused
IsPremium - <yellow>Premium Status in good standing<c>
NonPremium - <red>Premium Status has expired<c>
KakinGire - <red>Expired<c>
NetCafe - <green>Net Café Premium<c>


ConfigCategory
Group 0
Category_Control - コントロール
Category_Gameplay - ゲームプレイ
Category_Graphic - グラフィック
Category_Interface - インターフェース
Category_SoundAndChat - サウンド・チャット
Category_Other - その他

Group 1
Category_Control - Controls
Category_Gameplay - Gameplay
Category_Graphic - Graphics
Category_Interface - Interface
Category_SoundAndChat - Sound/Chat
Category_Other - Misc.


ConfigCommon
Group 0
Title_Config - オプション
Title_DetailInfo - 詳細情報
MenuButton_WindowReset - ウィンドウ初期化
MenuButton_Reset - 設定の初期化
MenuButton_Exit - 破棄して戻る
MenuButton_ExitWithSave - 変更を反映して戻る
ThreeChoiceMenuTitle - 終了確認
ThreeChoiceMenuMessageApply - オプション画面を閉じて戻ります。<br>変更を反映しますか？
ThreeChoiceMenuButtonExit - 破棄して戻る
ThreeChoiceMenuButtonExitWithSave - 変更を反映して戻る
ThreeChoiceMenuButtonCancel - キャンセル
ConfirmTitleInit - 初期化確認
ConfirmMessageInit - すべてのオプション設定を初期化します。<br>よろしいですか？
ConfirmTitle - 終了確認
ConfirmMessageApply - 変更を反映します。<br>よろしいですか？
ConfirmMessageDisapply - 変更を破棄します。<br>よろしいですか？
ConfirmButtonApply - 変更を反映して終了する
ConfirmButtonDisapply - 変更を破棄して終了する
ConfirmButtonCancel - オプションに戻る
ConfirmTitleWindowInit - ウィンドウ初期化確認
ConfirmMessageWindowInit - すべてのウィンドウの<br>表示位置と表示サイズを初期化します。<br>よろしいですか？
ConfirmMessageWindowInitEnd - ウィンドウの表示位置と表示サイズを初期化しました。
WindowTitleInitText - ウィンドウ初期化設定
WindowInitHint - 全ウィンドウの表示位置と表示サイズを<br>初期化します。
WindowRadioButtonInitText - 全ウィンドウの位置とサイズを初期化する

Group 1
Title_Config - Options
Title_DetailInfo - Detailed Information
MenuButton_WindowReset - Window Initialization
MenuButton_Reset - Restore Default Settings
MenuButton_Exit - Discard Changes & Return
MenuButton_ExitWithSave - Apply Changes & Return
ThreeChoiceMenuTitle - Confirm Exit
ThreeChoiceMenuMessageApply - Closing the Options screen and returning.<br>Do you wish to save your changes?
ThreeChoiceMenuButtonExit - Discard Changes & Return
ThreeChoiceMenuButtonExitWithSave - Apply Changes & Return
ThreeChoiceMenuButtonCancel - Cancel
ConfirmTitleInit - Confirm Reset to Default Settings
ConfirmMessageInit - All options will be reset to their default settings.<br>Are you sure you wish to proceed?
ConfirmTitle - Confirm Exit
ConfirmMessageApply - Your changes will be applied.<br>Are you sure you wish to proceed?
ConfirmMessageDisapply - Your changes will be discarded.<br>Are you sure you wish to proceed?
ConfirmButtonApply - Save Changes & Exit
ConfirmButtonDisapply - Discard Changes & Exit
ConfirmButtonCancel - Return to Options
ConfirmTitleWindowInit - Confirm Window Initialization
ConfirmMessageWindowInit - All window display sizes and positions will be reset.<br>Are you sure you wish to proceed?
ConfirmMessageWindowInitEnd - Window display sizes and positions initialized.
WindowTitleInitText - Window Initialization Settings
WindowInitHint - Window display sizes and positions initialized.
WindowRadioButtonInitText - Initialize all window display sizes and positions


ConfigSubject
Group 0
Subject_000 - アクション機能設定
Subject_001 - HUD設定
Subject_002 - メニュー設定
Subject_003 - ドロップアイテム自動取得機能
Subject_004 - その他の設定
Subject_005 - カメラ設定
Subject_006 - カメラ左右回転速度
Subject_007 - カメラ上下回転速度
Subject_008 - 与ダメージ表示
Subject_009 - 回復／被ダメージ表示
Subject_010 - EXPなどの表示
Subject_011 - ドロップアイテムの取得表示
Subject_012 - 確認通知
Subject_013 - メッセージ通知
Subject_014 - その他の通知
Subject_015 - 会話設定
Subject_016 - 他者のオートワード表示設定
Subject_017 - ログウィンドウの「すべて表示」に表示するチャンネル
Subject_018 - スクリーンショット設定
Subject_019 - エステ設定
Subject_020 - ライドロイド設定
Subject_021 - ダークブラスト設定
Subject_022 - BGM音量
Subject_023 - SE音量
Subject_024 - ボイス音量
Subject_025 - ゲーム内再生動画音量
Subject_026 - 再生機能
Subject_027 - 描画機能
Subject_028 - 詳細モデル表示数
Subject_029 - フォトンブラスト表示数
Subject_030 - 映り込み品質
Subject_031 - 影品質
Subject_032 - 画面の明るさ
Subject_033 - カメラライト
Subject_034 - マウス使用時補正
Subject_035 - ボイスチャット機能ON/OFF
Subject_036 - ウィッシュリスト、プレゼントリスト

Group 1
Subject_000 - Action Settings
Subject_001 - HUD Settings
Subject_002 - Menu Settings
Subject_003 - Auto Pick Up
Subject_004 - Other Settings
Subject_005 - Camera Settings
Subject_006 - Camera Rotation Speed (Left/Right)
Subject_007 - Camera Rotation Speed (Up/Down)
Subject_008 - Displays of Damage Dealt
Subject_009 - Displays of HP Recovery/Damage Taken
Subject_010 - Displays of EXP
Subject_011 - Obtained Item Display
Subject_012 - Confirmation Notifications
Subject_013 - Message Notifications
Subject_014 - Other Notifications
Subject_015 - Chat Settings
Subject_016 - Display Auto Chat from Other Users
Subject_017 - Channels Featured in "Display All" Log Window
Subject_018 - Screenshot Settings
Subject_019 - Salon Settings
Subject_020 - Ridroid Settings
Subject_021 - Dark Blast Settings
Subject_022 - BGM Volume
Subject_023 - Sound Effects Volume
Subject_024 - Voice Volume
Subject_025 - In-Game Video Playback Volume
Subject_026 - Playback Settings
Subject_027 - Graphics Features
Subject_028 - Max Detailed Model Display
Subject_029 - Max Photon Blast Display
Subject_030 - Reflection Quality
Subject_031 - Shadow Quality
Subject_032 - Screen Brightness
Subject_033 - Camera Lighting
Subject_034 - Mouse Correction
Subject_035 - Voice Chat ON/OFF
Subject_036 - ウィッシュリスト、プレゼントリストの表示/非表示*


InitPadInput
Group 0
Config_PadInput01 - ゲームパッドタイプ選択
Config_PadInput02 - ゲームパッドとタイプの組み合わせにより、<br>正常に動作しなくなる場合があります。<br>その場合は、タイプを切り替えてください。
Config_PadInput03 - -
Config_PadInput04 - -
Config_PadInput05 - -
Config_PadInput06 - ゲームパッド振動切り替え
Config_PadInput07 - 「XInput」を選択している場合のみ振動します。<br>※ゲームパッドにより、振動しない場合があります。
Config_PadInput08 - -
Config_PadInput09 - -
Config_PadInput10 - -
Config_PadInput11 - -
Config_PadInput12 - 非アクティブ時のゲームパッド操作
Config_PadInput13 - アプリケーションが非アクティブのときに<br>ゲームパッドの入力を受け付けるか設定します。
Config_PadInput14 - -
Config_PadInput15 - -
Config_PadInput16 - -
Config_PadInput17 - ゲームパッド初期設定
Config_PadInput18 - 「DirectInput」を選択している場合のみ設定できます。

Group 1
Config_PadInput01 - Gamepad Type Selection
Config_PadInput02 - Certain gamepad and input type<br>combinations may not work properly.<br>Please change the input type if this occurs.
Config_PadInput03 - Input Type
Config_PadInput04 - Direct Input
Config_PadInput05 - X Input
Config_PadInput06 - Toggle Gamepad Vibration
Config_PadInput07 - Vibration only available when X Input is selected.<br>Note: Certain gamepads may not support vibration.
Config_PadInput08 - Gamepad Vibration
Config_PadInput09 - On
Config_PadInput10 - Off
Config_PadInput11 - Gamepad Options
Config_PadInput12 - Inactive Gamepad Control
Config_PadInput13 - Set whether gamepad inputs are accepted<br>when the application is inactive.
Config_PadInput14 - Gamepad Input
Config_PadInput15 - Enable
Config_PadInput16 - Disable
Config_PadInput17 - Default Gamepad Settings
Config_PadInput18 - Can be set only when "DirectInput" is selected.


